sample_prefix	pop	total	secondary	supplementary	duplicates	mapped	mapped.perc	paired	read1	read2	properly_paired	properly_paired.perc	both_mapped	singletons	singletons.perc	different_chr	different_chr_mapQ>=5
01b_01	01b	110765	0	3231	0	109183	98.57	107534	53767	53767	100182	93.16	105328	624	0.58	4496	3705
01b_02	01b	3644971	0	93627	0	3607519	98.97	3551344	1775672	1775672	3409068	95.99	3504878	9014	0.25	75820	50009
01b_03	01b	1624728	0	50446	0	1610142	99.10	1574282	787141	787141	1498786	95.20	1554904	4792	0.30	45564	35392
01b_04	01b	28956	0	1150	0	28361	97.95	27806	13903	13903	24962	89.77	27022	189	0.68	1966	1721
01b_05	01b	2186608	0	66974	0	2163356	98.94	2119634	1059817	1059817	2010600	94.86	2089286	7096	0.33	64664	48893
01b_06	01b	5517571	0	133423	0	5497835	99.64	5384148	2692074	2692074	5192560	96.44	5359274	5138	0.10	150152	127958
01b_07	01b	105876	0	2130	0	105201	99.36	103746	51873	51873	98870	95.30	102724	347	0.33	3402	2951
01b_08	01b	1687801	0	47187	0	1673739	99.17	1640614	820307	820307	1567526	95.55	1621914	4638	0.28	44012	32618
01b_09	01b	731712	0	16580	0	728355	99.54	715132	357566	357566	685550	95.86	711074	701	0.10	23158	20797
01b_10	01b	4089624	0	79002	0	4076468	99.68	4010622	2005311	2005311	3898360	97.20	3995090	2376	0.06	88822	73681
01b_11	01b	96317	0	2641	0	95489	99.14	93676	46838	46838	88550	94.53	92740	108	0.12	3624	3250
01b_12	01b	4049689	0	81143	0	4032299	99.57	3968546	1984273	1984273	3849926	97.01	3947098	4058	0.10	90120	75852
01b_13	01b	240499	0	7741	0	239475	99.57	232758	116379	116379	220578	94.77	231218	516	0.22	10024	8660
01b_14	01b	2320061	0	32417	0	2312707	99.68	2287644	1143822	1143822	2240146	97.92	2278888	1402	0.06	35410	27466
01b_15	01b	77903	0	2171	0	77227	99.13	75732	37866	37866	72610	95.88	74984	72	0.10	2146	1871
01b_16	01b	3779469	0	80319	0	3765134	99.62	3699150	1849575	1849575	3587620	96.98	3681168	3647	0.10	86304	72805
01b_17	01b	888862	0	18440	0	884629	99.52	870422	435211	435211	838912	96.38	865200	989	0.11	23776	20541
01b_18	01b	663919	0	17545	0	661585	99.65	646374	323187	323187	621900	96.21	643324	716	0.11	19488	17313
01b_19	01b	3594359	0	72577	0	3583724	99.70	3521782	1760891	1760891	3414164	96.94	3508936	2211	0.06	82938	68932
01b_20	01b	2439351	0	54051	0	2428338	99.55	2385300	1192650	1192650	2299146	96.39	2371840	2447	0.10	64970	56211
01b_21	01b	154722	0	3968	0	153510	99.22	150754	75377	75377	143090	94.92	149230	312	0.21	5490	4793
01b_22	01b	1162706	0	21742	0	1159645	99.74	1140964	570482	570482	1110678	97.35	1137036	867	0.08	24058	20193
01b_23	01b	776174	0	19132	0	773499	99.66	757042	378521	378521	728578	96.24	753596	771	0.10	23482	20233
01b_24	01b	1414603	0	32465	0	1410153	99.69	1382138	691069	691069	1337956	96.80	1375956	1732	0.13	35400	30145
01b_25	01b	4276848	0	56838	0	4252620	99.43	4220010	2110005	2110005	4132210	97.92	4192104	3678	0.09	54482	41748
01b_26	01b	233767	0	5067	0	233111	99.72	228700	114350	114350	220460	96.40	227776	268	0.12	6480	5728
01b_27	01b	2226482	0	49604	0	2215505	99.51	2176878	1088439	1088439	2103830	96.64	2163742	2159	0.10	54696	45014
01b_28	01b	1942898	0	42270	0	1936691	99.68	1900628	950314	950314	1836412	96.62	1892288	2133	0.11	49488	42555
01b_29	01b	11700046	0	236284	0	11658958	99.65	11463762	5731881	5731881	11118506	96.99	11411584	11090	0.10	258806	216220
01b_30	01b	1358159	0	32113	0	1353561	99.66	1326046	663023	663023	1274736	96.13	1319484	1964	0.15	40744	35634
01b_31	01b	1369179	0	32241	0	1364380	99.65	1336938	668469	668469	1289884	96.48	1330964	1175	0.09	37210	30590
01b_32	01b	3634414	0	61572	0	3622831	99.68	3572842	1786421	1786421	3480924	97.43	3557848	3411	0.10	67448	55526
01b_33	01b	4473234	0	81258	0	4454971	99.59	4391976	2195988	2195988	4271978	97.27	4370792	2921	0.07	89382	72192
01b_34	01b	278508	0	7546	0	277668	99.70	270962	135481	135481	258502	95.40	269878	244	0.09	9786	8222
01b_35	01b	270124	0	5306	0	268596	99.43	264818	132409	132409	254824	96.23	262804	486	0.18	7516	5929
01b_36	01b	5196688	0	94126	0	5179035	99.66	5102562	2551281	2551281	4970712	97.42	5080620	4289	0.08	101202	83691
01b_37	01b	84893	0	1383	0	84434	99.46	83510	41755	41755	80454	96.34	82890	161	0.19	2084	1782
01b_38	01b	27944	0	636	0	27881	99.77	27308	13654	13654	26066	95.45	27182	63	0.23	1000	940
01b_39	01b	2515968	0	58638	0	2498834	99.32	2457330	1228665	1228665	2368716	96.39	2437978	2218	0.09	63270	54391
01b_40	01b	2392597	0	49945	0	2381319	99.53	2342652	1171326	1171326	2266186	96.74	2328752	2622	0.11	57164	48948
01b_41	01b	684932	0	17916	0	683072	99.73	667016	333508	333508	641384	96.16	664458	698	0.10	21010	18411
01b_42	01b	735066	0	18954	0	733257	99.75	716112	358056	358056	692572	96.71	713594	709	0.10	19232	16557
01b_43	01b	616838	0	14490	0	614645	99.64	602348	301174	301174	581852	96.60	599660	495	0.08	15768	13330
01b_44	01b	70034	0	1674	0	69691	99.51	68360	34180	34180	65078	95.20	67870	147	0.22	2442	1889
01b_45	01b	3405840	0	61136	0	3397308	99.75	3344704	1672352	1672352	3259452	97.45	3333388	2784	0.08	62916	52387
01b_46	01b	9056	0	236	0	9004	99.43	8820	4410	4410	8054	91.32	8724	44	0.50	652	590
01b_47	01b	59853441	0	816991	0	59629238	99.63	59036450	29518225	29518225	57941742	98.15	58765900	46347	0.08	735488	562548
01b_48	01b	54933817	0	625075	0	54801245	99.76	54308742	27154371	27154371	53417454	98.36	54124414	51756	0.10	618984	466132
04b_01	04b	3039	0	69	0	2073	68.21	2970	1485	1485	1346	45.32	1814	190	6.40	438	394
04b_03	04b	30956	0	396	0	29878	96.52	30560	15280	15280	28308	92.63	29354	128	0.42	748	585
04b_05	04b	8353	0	365	0	7454	89.24	7988	3994	3994	5610	70.23	6796	293	3.67	1118	856
04b_07	04b	44975	0	425	0	44295	98.49	44550	22275	22275	42654	95.74	43636	234	0.53	956	826
04b_11	04b	81672	0	752	0	79527	97.37	80920	40460	40460	77274	95.49	78488	287	0.35	996	851
04b_15	04b	25623	0	399	0	24699	96.39	25224	12612	12612	22872	90.68	23984	316	1.25	1052	905
04b_16	04b	5411	0	137	0	4203	77.68	5274	2637	2637	3326	63.06	3936	130	2.46	582	540
04b_20	04b	16491	0	339	0	15101	91.57	16152	8076	8076	12660	78.38	14354	408	2.53	1596	1439
04b_23	04b	4629	0	159	0	3395	73.34	4470	2235	2235	2166	48.46	2866	370	8.28	678	618
04b_47	04b	703946	0	6254	0	696137	98.89	697692	348846	348846	683898	98.02	689226	657	0.09	4958	3269
04b_48	04b	21313	0	207	0	16494	77.39	21106	10553	10553	15180	71.92	15988	299	1.42	746	665
04b_49	04b	35180	0	502	0	33428	95.02	34678	17339	17339	30506	87.97	32472	454	1.31	1894	1580
04b_50	04b	7476	0	132	0	6416	85.82	7344	3672	3672	5274	71.81	5908	376	5.12	622	545
05abc_01	05abc	1689907	0	15933	0	1680677	99.45	1673974	836987	836987	1652122	98.69	1663730	1014	0.06	10578	7185
05abc_02	05abc	423616	0	3754	0	418439	98.78	419862	209931	209931	410342	97.73	414000	685	0.16	3008	2175
05abc_04	05abc	2041133	0	23005	0	2028029	99.36	2018128	1009064	1009064	1985836	98.40	2003942	1082	0.05	16466	11614
05abc_05	05abc	3527018	0	42086	0	3500817	99.26	3484932	1742466	1742466	3414314	97.97	3456530	2201	0.06	38878	29906
05abc_06	05abc	2815148	0	34698	0	2796995	99.36	2780450	1390225	1390225	2735380	98.38	2760122	2175	0.08	20394	15217
05abc_07	05abc	36216	0	150	0	17060	47.11	36066	18033	18033	16028	44.44	16662	248	0.69	604	500
05abc_08	05abc	4124052	0	54568	0	4094490	99.28	4069484	2034742	2034742	3995144	98.17	4036990	2932	0.07	38138	29171
05abc_09	05abc	1037704	0	12944	0	1026869	98.96	1024760	512380	512380	1002322	97.81	1012972	953	0.09	9532	7035
05abc_10	05abc	2355417	0	31749	0	2332165	99.01	2323668	1161834	1161834	2271288	97.75	2298678	1738	0.07	24642	18202
05abc_11	05abc	8313	0	71	0	4266	51.32	8242	4121	4121	3656	44.36	4112	83	1.01	442	387
05abc_12	05abc	3096910	0	27020	0	3083841	99.58	3069890	1534945	1534945	3033606	98.82	3054470	2351	0.08	15856	9090
05abc_13	05abc	6315566	0	96482	0	6270341	99.28	6219084	3109542	3109542	6077402	97.72	6169478	4381	0.07	81764	62896
05abc_14	05abc	89906	0	1022	0	75074	83.50	88884	44442	44442	72570	81.65	73636	416	0.47	934	740
05abc_15	05abc	579674	0	7344	0	570558	98.43	572330	286165	286165	555402	97.04	562218	996	0.17	5404	3974
05abc_16	05abc	1034634	0	12684	0	1018688	98.46	1021950	510975	510975	992304	97.10	1004214	1790	0.18	9882	7852
05abc_17	05abc	603034	0	8322	0	592965	98.33	594712	297356	297356	577104	97.04	583832	811	0.14	6050	4512
05abc_18	05abc	2342124	0	32610	0	2327422	99.37	2309514	1154757	1154757	2263340	98.00	2293110	1702	0.07	25364	19441
05abc_19	05abc	1553304	0	15958	0	1540975	99.21	1537346	768673	768673	1513858	98.47	1523942	1075	0.07	9186	6941
05abc_20	05abc	483932	0	3980	0	478867	98.95	479952	239976	239976	469620	97.85	474248	639	0.13	3920	2848
05abc_21	05abc	1328606	0	19014	0	1318021	99.20	1309592	654796	654796	1280312	97.76	1297822	1185	0.09	15566	12045
05abc_23	05abc	522264	0	8170	0	507588	97.19	514094	257047	257047	488322	94.99	498680	738	0.14	8574	6960
05abc_24	05abc	143690	0	2080	0	138219	96.19	141610	70805	70805	133230	94.08	135930	209	0.15	2174	1664
05abc_25	05abc	1350176	0	30720	0	1339996	99.25	1319456	659728	659728	1275800	96.69	1307926	1350	0.10	28702	24418
05abc_26	05abc	4910	0	206	0	3144	64.03	4704	2352	2352	1582	33.63	2672	266	5.65	1034	952
05abc_27	05abc	240783	0	3487	0	237255	98.53	237296	118648	118648	230090	96.96	233452	316	0.13	3100	2513
05abc_29	05abc	1569693	0	26875	0	1561387	99.47	1542818	771409	771409	1507128	97.69	1533302	1210	0.08	23810	19026
05abc_30	05abc	2104657	0	30681	0	2066722	98.20	2073976	1036988	1036988	2006494	96.75	2033884	2157	0.10	25672	20277
05abc_31	05abc	4318388	0	73920	0	4286316	99.26	4244468	2122234	2122234	4145042	97.66	4208986	3410	0.08	57302	45418
05abc_32	05abc	953703	0	16551	0	943355	98.91	937152	468576	468576	909648	97.07	925692	1112	0.12	14624	12418
05abc_33	05abc	836628	0	13840	0	829290	99.12	822788	411394	411394	800202	97.25	814586	864	0.11	12658	9564
05abc_34	05abc	2218828	0	43144	0	2204300	99.35	2175684	1087842	1087842	2113090	97.12	2159170	1986	0.09	42018	35486
05abc_35	05abc	585702	0	7564	0	580740	99.15	578138	289069	289069	565132	97.75	572572	604	0.10	6926	5366
05abc_36	05abc	195842	0	3306	0	192966	98.53	192536	96268	96268	184426	95.79	189214	446	0.23	4428	3719
05abc_37	05abc	363875	0	8399	0	359907	98.91	355476	177738	177738	344514	96.92	351098	410	0.12	6056	4523
05abc_38	05abc	392873	0	3203	0	385853	98.21	389670	194835	194835	378600	97.16	381912	738	0.19	3172	2445
05abc_39	05abc	851317	0	13191	0	843712	99.11	838126	419063	419063	817294	97.51	829658	863	0.10	11702	9671
05abc_40	05abc	30131	0	545	0	27966	92.81	29586	14793	14793	26290	88.86	27186	235	0.79	856	741
05abc_41	05abc	4632244	0	56340	0	4588158	99.05	4575904	2287952	2287952	4477954	97.86	4527624	4194	0.09	44208	33057
05abc_42	05abc	179560	0	2942	0	174923	97.42	176618	88309	88309	167724	94.96	171358	623	0.35	3342	2621
05abc_43	05abc	93348	0	1360	0	91605	98.13	91988	45994	45994	88086	95.76	89898	347	0.38	1758	1606
05abc_44	05abc	342420	0	3282	0	340401	99.41	339138	169569	169569	333690	98.39	336730	389	0.11	2940	2333
05abc_45	05abc	102304	0	1362	0	100451	98.19	100942	50471	50471	97854	96.94	98886	203	0.20	970	653
05abc_46	05abc	1186568	0	14860	0	1181634	99.58	1171708	585854	585854	1150376	98.18	1166020	754	0.06	13792	10971
05abc_47	05abc	26832	0	310	0	24733	92.18	26522	13261	13261	23428	88.33	24174	249	0.94	722	618
05abc_48	05abc	199362	0	4318	0	197415	99.02	195044	97522	97522	187700	96.23	192652	445	0.23	4780	4384
05abc_49	05abc	75381	0	1367	0	74187	98.42	74014	37007	37007	70644	95.45	72474	346	0.47	1580	1380
05abc_50	05abc	209521	0	3019	0	207828	99.19	206502	103251	103251	201590	97.62	204456	353	0.17	2694	2079
06a_01	06a	676005	0	7149	0	673861	99.68	668856	334428	334428	656466	98.15	665814	898	0.13	8360	6823
06a_02	06a	737206	0	8262	0	733853	99.55	728944	364472	364472	715958	98.22	724850	741	0.10	8192	6653
06a_03	06a	572149	0	7175	0	570791	99.76	564974	282487	282487	553668	98.00	563178	438	0.08	8458	6711
06a_04	06a	355663	0	5533	0	354072	99.55	350130	175065	175065	339766	97.04	348002	537	0.15	7328	5770
06a_05	06a	334416	0	4584	0	332913	99.55	329832	164916	164916	319656	96.91	327410	919	0.28	7234	6204
06a_06	06a	2470482	0	33180	0	2463632	99.72	2437302	1218651	1218651	2386974	97.94	2428728	1724	0.07	37814	26061
06a_07	06a	623804	0	10336	0	620496	99.47	613468	306734	306734	597514	97.40	609550	610	0.10	10686	8315
06a_08	06a	791105	0	13179	0	788900	99.72	777926	388963	388963	758836	97.55	775036	685	0.09	13978	11552
06a_09	06a	441330	0	5396	0	439859	99.67	435934	217967	217967	427078	97.97	434022	441	0.10	5672	4226
06a_10	06a	1116173	0	17777	0	1113111	99.73	1098396	549198	549198	1071984	97.60	1094246	1088	0.10	20074	16397
06a_11	06a	402736	0	4512	0	400287	99.39	398224	199112	199112	390304	98.01	395358	417	0.10	4648	3841
06a_12	06a	2277382	0	31428	0	2269842	99.67	2245954	1122977	1122977	2200490	97.98	2236318	2096	0.09	31626	26896
06a_13	06a	1473698	0	24168	0	1470155	99.76	1449530	724765	724765	1411164	97.35	1444898	1089	0.08	29478	23507
06a_14	06a	2449040	0	37916	0	2443091	99.76	2411124	1205562	1205562	2360498	97.90	2403666	1509	0.06	38226	28802
06a_15	06a	246565	0	3495	0	244748	99.26	243070	121535	121535	236870	97.45	241052	201	0.08	3866	3230
06a_16	06a	934604	0	17472	0	931944	99.72	917132	458566	458566	892888	97.36	913576	896	0.10	18418	15772
06a_17	06a	69418	0	1466	0	69001	99.40	67952	33976	33976	64384	94.75	67256	279	0.41	2704	2410
06a_18	06a	310799	0	5391	0	309829	99.69	305408	152704	152704	297706	97.48	304190	248	0.08	5770	4370
06a_19	06a	138800	0	2938	0	138354	99.68	135862	67931	67931	130848	96.31	135220	196	0.14	4086	3330
06a_20	06a	806034	0	14800	0	803716	99.71	791234	395617	395617	771830	97.55	788190	726	0.09	14742	12583
06a_21	06a	3121608	0	58968	0	3111395	99.67	3062640	1531320	1531320	2968984	96.94	3049668	2759	0.09	71484	60636
06a_22	06a	1995700	0	26314	0	1988627	99.65	1969386	984693	984693	1930790	98.04	1960830	1483	0.08	27362	21371
06a_23	06a	418087	0	6979	0	416160	99.54	411108	205554	205554	399536	97.19	408330	851	0.21	8160	6502
06a_24	06a	810142	0	10116	0	806924	99.60	800026	400013	400013	783610	97.95	795908	900	0.11	10560	8375
06a_26	06a	948838	0	10818	0	945811	99.68	938020	469010	469010	923092	98.41	934224	769	0.08	9788	7109
06a_27	06a	998854	0	15206	0	996737	99.79	983648	491824	491824	964060	98.01	980788	743	0.08	15436	11850
06a_28	06a	3294169	0	45745	0	3283307	99.67	3248424	1624212	1624212	3184454	98.03	3235076	2486	0.08	43748	35587
06a_29	06a	235821	0	3171	0	234842	99.58	232650	116325	116325	224458	96.48	231042	629	0.27	6112	5170
06a_30	06a	2115719	0	25751	0	2108332	99.65	2089968	1044984	1044984	2052986	98.23	2081142	1439	0.07	25664	20308
06a_31	06a	83910	0	1826	0	83325	99.30	82084	41042	41042	78694	95.87	81320	179	0.22	2412	2043
06a_33	06a	1464368	0	19720	0	1459908	99.70	1444648	722324	722324	1416106	98.02	1438826	1362	0.09	19520	15148
06a_34	06a	3387671	0	44195	0	3378514	99.73	3343476	1671738	1671738	3280882	98.13	3331522	2797	0.08	45828	35669
06a_35	06a	591977	0	8669	0	590510	99.75	583308	291654	291654	571782	98.02	581296	545	0.09	8670	7216
06a_36	06a	1223507	0	21153	0	1219576	99.68	1202354	601177	601177	1173106	97.57	1197576	847	0.07	22376	18152
06a_37	06a	509964	0	10706	0	508502	99.71	499258	249629	249629	486076	97.36	497382	414	0.08	10386	8587
06a_38	06a	225070	0	3292	0	223856	99.46	221778	110889	110889	215476	97.16	220206	358	0.16	4172	3363
06a_39	06a	5886917	0	101229	0	5870700	99.72	5785688	2892844	2892844	5636536	97.42	5765492	3979	0.07	106214	86126
06a_40	06a	239052	0	4436	0	237611	99.40	234616	117308	117308	227540	96.98	232970	205	0.09	5024	3970
06a_41	06a	2304970	0	33112	0	2299391	99.76	2271858	1135929	1135929	2223818	97.89	2264380	1899	0.08	37156	29329
06a_42	06a	6288487	0	93483	0	6270721	99.72	6195004	3097502	3097502	6068760	97.96	6171562	5676	0.09	93330	71400
06a_43	06a	937250	0	15392	0	934915	99.75	921858	460929	460929	900436	97.68	918960	563	0.06	17574	14232
06a_44	06a	470507	0	9349	0	469340	99.75	461158	230579	230579	447698	97.08	459570	421	0.09	10698	8379
06a_45	06a	729442	0	11098	0	726971	99.66	718344	359172	359172	702870	97.85	715462	411	0.06	10398	8677
06a_46	06a	764466	0	15752	0	762376	99.73	748714	374357	374357	727346	97.15	745916	708	0.09	16754	14074
06a_47	06a	2450339	0	39175	0	2445016	99.78	2411164	1205582	1205582	2363090	98.01	2404192	1649	0.07	35968	29480
06a_48	06a	803664	0	16090	0	800834	99.65	787574	393787	393787	765548	97.20	784064	680	0.09	16174	12799
06a_49	06a	540156	0	11206	0	537840	99.57	528950	264475	264475	511254	96.65	525542	1092	0.21	13144	11233
06a_50	06a	1523342	0	25574	0	1518911	99.71	1497768	748884	748884	1456048	97.21	1491650	1687	0.11	30242	25823
06c_01	06c	2308988	0	23842	0	2292594	99.29	2285146	1142573	1142573	2242378	98.13	2265430	3322	0.15	20866	11420
06c_02	06c	2151861	0	26623	0	2143990	99.63	2125238	1062619	1062619	2069488	97.38	2113328	4039	0.19	34926	25434
06c_03	06c	477431	0	4643	0	475305	99.55	472788	236394	236394	463148	97.96	469838	824	0.17	6116	5588
06c_04	06c	364902	0	2996	0	361319	99.02	361906	180953	180953	352680	97.45	357402	921	0.25	4146	3342
06c_05	06c	63973	0	1027	0	54621	85.38	62946	31473	31473	50828	80.75	53228	366	0.58	2246	1835
06c_06	06c	22028	0	626	0	21277	96.59	21402	10701	10701	17054	79.68	20020	631	2.95	2854	2621
06c_07	06c	163247	0	1293	0	162643	99.63	161954	80977	80977	158152	97.65	161042	308	0.19	2732	2118
06c_08	06c	803132	0	10454	0	793553	98.81	792678	396339	396339	771362	97.31	782088	1011	0.13	9806	8443
06c_09	06c	4028091	0	49297	0	4012273	99.61	3978794	1989397	1989397	3898564	97.98	3958470	4506	0.11	53538	33321
06c_100	06c	5186712	0	41700	0	5165201	99.59	5145012	2572506	2572506	5076498	98.67	5119050	4451	0.09	35566	21605
06c_10	06c	642531	0	8313	0	635911	98.97	634218	317109	317109	614542	96.90	626472	1126	0.18	10038	7725
06c_11	06c	162086	0	1478	0	161761	99.80	160608	80304	80304	158016	98.39	159982	301	0.19	1616	1447
06c_12	06c	118479	0	1277	0	117842	99.46	117202	58601	58601	114368	97.58	116316	249	0.21	1620	1413
06c_13	06c	703711	0	7997	0	701918	99.75	695714	347857	347857	681970	98.02	692274	1647	0.24	9830	5313
06c_14	06c	7931	0	799	0	7596	95.78	7132	3566	3566	3536	49.58	6484	313	4.39	2832	2532
06c_15	06c	10933	0	141	0	10884	99.55	10792	5396	5396	9596	88.92	10698	45	0.42	390	329
06c_16	06c	58762	0	572	0	54512	92.77	58190	29095	29095	52488	90.20	53778	162	0.28	910	669
06c_17	06c	741927	0	9313	0	738086	99.48	732614	366307	366307	715478	97.66	727574	1199	0.16	11494	9201
06c_18	06c	417219	0	8877	0	413976	99.22	408342	204171	204171	393310	96.32	404252	847	0.21	10030	8205
06c_19	06c	254966	0	3314	0	252314	98.96	251652	125826	125826	243112	96.61	248084	916	0.36	4704	3314
06c_20	06c	395214	0	6028	0	392724	99.37	389186	194593	194593	376402	96.72	385688	1008	0.26	8822	6927
06c_21	06c	12814	0	364	0	12612	98.42	12450	6225	6225	11112	89.25	12086	162	1.30	950	676
06c_22	06c	5089	0	159	0	5023	98.70	4930	2465	2465	4250	86.21	4802	62	1.26	460	388
06c_23	06c	3400	0	314	0	3299	97.03	3086	1543	1543	1916	62.09	2892	93	3.01	948	869
06c_24	06c	14757	0	413	0	14304	96.93	14344	7172	7172	11036	76.94	13446	445	3.10	2052	1777
06c_25	06c	506029	0	8789	0	495460	97.91	497240	248620	248620	472354	95.00	485570	1101	0.22	12684	11040
06c_29	06c	139105	0	2453	0	136882	98.40	136652	68326	68326	130052	95.17	133570	859	0.63	3442	3173
06c_30	06c	206108	0	2346	0	194098	94.17	203762	101881	101881	187380	91.96	191186	566	0.28	3666	2585
06c_31	06c	1087692	0	14272	0	1066331	98.04	1073420	536710	536710	1033164	96.25	1049824	2235	0.21	14872	12060
06c_32	06c	86719	0	1635	0	86062	99.24	85084	42542	42542	80762	94.92	83894	533	0.63	2908	2514
06c_33	06c	40573	0	919	0	39582	97.56	39654	19827	19827	35832	90.36	38274	389	0.98	1622	1483
06c_34	06c	32487	0	727	0	28910	88.99	31760	15880	15880	26718	84.12	28026	157	0.49	1210	1093
06c_35	06c	8739	0	409	0	8280	94.75	8330	4165	4165	6546	78.58	7728	143	1.72	1120	876
06c_37	06c	335321	0	4131	0	333288	99.39	331190	165595	165595	324744	98.05	328736	421	0.13	3610	2425
06c_38	06c	35466	0	290	0	35240	99.36	35176	17588	17588	33602	95.53	34748	202	0.57	1084	987
06c_39	06c	158198	0	2238	0	157056	99.28	155960	77980	77980	150772	96.67	153982	836	0.54	3014	2415
06c_40	06c	74859	0	893	0	74580	99.63	73966	36983	36983	71456	96.61	73430	257	0.35	1936	1491
06c_41	06c	15439	0	471	0	15015	97.25	14968	7484	7484	12316	82.28	14148	396	2.65	1744	1594
06c_42	06c	31437	0	269	0	30870	98.20	31168	15584	15584	29202	93.69	30378	223	0.72	1136	972
06c_43	06c	28223	0	285	0	3192	11.31	27938	13969	13969	1834	6.56	2838	69	0.25	948	869
06c_44	06c	22811	0	327	0	21658	94.95	22484	11242	11242	20058	89.21	21144	187	0.83	1018	930
06c_45	06c	190338	0	2026	0	188440	99.00	188312	94156	94156	182752	97.05	185838	576	0.31	2970	2555
06c_46	06c	16024	0	380	0	15583	97.25	15644	7822	7822	13544	86.58	14914	289	1.85	1286	1180
06c_47	06c	32104	0	762	0	31695	98.73	31342	15671	15671	28184	89.92	30554	379	1.21	2314	2164
06c_48	06c	6039	0	461	0	5133	85.00	5578	2789	2789	2816	50.48	4430	242	4.34	1544	1402
06c_49	06c	12089	0	257	0	11774	97.39	11832	5916	5916	10176	86.00	11242	275	2.32	1028	945
06c_50	06c	632	0	64	0	621	98.26	568	284	284	332	58.45	546	11	1.94	208	189
06c_51	06c	314710	0	1984	0	248682	79.02	312726	156363	156363	241882	77.35	244620	2078	0.66	2634	1667
06c_52	06c	60233	0	561	0	31194	51.79	59672	29836	29836	28258	47.36	29788	845	1.42	1202	1005
06c_53	06c	110396	0	828	0	79544	72.05	109568	54784	54784	76666	69.97	77704	1012	0.92	1010	657
06c_54	06c	373549	0	3061	0	310745	83.19	370488	185244	185244	303320	81.87	305136	2548	0.69	1284	705
06c_55	06c	753955	0	6223	0	709979	94.17	747732	373866	373866	696934	93.21	702228	1528	0.20	4430	2653
06c_56	06c	533707	0	3833	0	462929	86.74	529874	264937	264937	451720	85.25	455922	3174	0.60	3562	2159
06c_57	06c	133526	0	190	0	29768	22.29	133336	66668	66668	24004	18.00	25604	3974	2.98	1266	182
06c_58	06c	120269	0	847	0	80670	67.07	119422	59711	59711	76746	64.26	78348	1475	1.24	1492	941
06c_59	06c	138705	0	1009	0	108084	77.92	137696	68848	68848	103672	75.29	105490	1585	1.15	1762	1304
06c_60	06c	15394	0	318	0	5037	32.72	15076	7538	7538	3160	20.96	3866	853	5.66	666	559
06c_61	06c	12246	0	26	0	2461	20.10	12220	6110	6110	1788	14.63	1996	439	3.59	188	109
06c_62	06c	35979	0	355	0	26074	72.47	35624	17812	17812	25008	70.20	25622	97	0.27	596	395
06c_63	06c	364691	0	1377	0	320691	87.93	363314	181657	181657	314778	86.64	317650	1664	0.46	2258	1651
06c_65	06c	856816	0	5986	0	836088	97.58	850830	425415	425415	824156	96.86	828922	1180	0.14	4532	3275
06c_66	06c	55236	0	212	0	35879	64.96	55024	27512	27512	33940	61.68	34804	863	1.57	822	633
06c_68	06c	211841	0	1635	0	200909	94.84	210206	105103	105103	196976	93.71	198840	434	0.21	1814	1266
06c_69	06c	64285	0	655	0	47745	74.27	63630	31815	31815	44402	69.78	45932	1158	1.82	1440	1128
06c_70	06c	20012	0	188	0	13618	68.05	19824	9912	9912	11758	59.31	12926	504	2.54	1132	978
06c_71	06c	24573	0	197	0	20569	83.71	24376	12188	12188	19470	79.87	20152	220	0.90	652	586
06c_72	06c	34001	0	199	0	11770	34.62	33802	16901	16901	9600	28.40	10904	667	1.97	1256	785
06c_73	06c	79074	0	352	0	49228	62.26	78722	39361	39361	46080	58.54	47276	1600	2.03	1090	635
06c_74	06c	48253	0	343	0	25991	53.86	47910	23955	23955	23634	49.33	24748	900	1.88	1024	689
06c_75	06c	129089	0	1121	0	103151	79.91	127968	63984	63984	100416	78.47	101316	714	0.56	860	693
06c_76	06c	387063	0	4063	0	377605	97.56	383000	191500	191500	366198	95.61	371428	2114	0.55	4964	3283
06c_77	06c	105672	0	1772	0	95549	90.42	103900	51950	51950	90158	86.77	93020	757	0.73	2600	2205
06c_78	06c	4780	0	104	0	2523	52.78	4676	2338	2338	1682	35.97	1932	487	10.41	240	220
06c_79	06c	7605	0	157	0	4019	52.85	7448	3724	3724	3212	43.13	3562	300	4.03	322	294
06c_80	06c	15486	0	20	0	5020	32.42	15466	7733	7733	3822	24.71	4404	596	3.85	556	243
06c_81	06c	28637	0	305	0	23621	82.48	28332	14166	14166	22308	78.74	23076	240	0.85	738	580
06c_82	06c	10550	0	56	0	3357	31.82	10494	5247	5247	2612	24.89	3032	269	2.56	408	234
06c_83	06c	14168	0	150	0	7231	51.04	14018	7009	7009	5954	42.47	6552	529	3.77	568	508
06c_84	06c	7575	0	119	0	4440	58.61	7456	3728	3728	3070	41.17	4018	303	4.06	882	760
06c_85	06c	6418	0	68	0	3369	52.49	6350	3175	3175	2186	34.43	2724	577	9.09	512	370
06c_86	06c	6942	0	40	0	3038	43.76	6902	3451	3451	2660	38.54	2890	108	1.56	222	190
06c_87	06c	4462	0	32	0	1730	38.77	4430	2215	2215	1322	29.84	1588	110	2.48	262	214
06c_88	06c	6406	0	72	0	2398	37.43	6334	3167	3167	1448	22.86	1970	356	5.62	502	423
06c_89	06c	21175	0	271	0	18934	89.42	20904	10452	10452	17132	81.96	18260	403	1.93	1092	953
06c_90	06c	8756	0	142	0	3778	43.15	8614	4307	4307	3062	35.55	3436	200	2.32	368	301
06c_91	06c	7598	0	606	0	4829	63.56	6992	3496	3496	3124	44.68	3792	431	6.16	624	563
06c_92	06c	5493	0	125	0	2640	48.06	5368	2684	2684	1748	32.56	2318	197	3.67	534	481
06c_93	06c	11495	0	215	0	7957	69.22	11280	5640	5640	4916	43.58	6886	856	7.59	1868	1678
06c_94	06c	5113	0	115	0	3823	74.77	4998	2499	2499	2934	58.70	3270	438	8.76	322	278
06c_95	06c	39111	0	359	0	29205	74.67	38752	19376	19376	26662	68.80	28252	594	1.53	1532	1361
06c_96	06c	265640	0	2956	0	260064	97.90	262684	131342	131342	254208	96.77	256816	292	0.11	2174	1358
06c_97	06c	170983	0	1191	0	162030	94.76	169792	84896	84896	158760	93.50	160352	487	0.29	1406	1036
06c_98	06c	709177	0	7335	0	690951	97.43	701842	350921	350921	675168	96.20	682616	1000	0.14	6116	4418
06c_99	06c	3353146	0	35284	0	3338364	99.56	3317862	1658931	1658931	3271392	98.60	3300218	2862	0.09	25624	15826
07a_01	07a	399429	0	6361	0	396713	99.32	393068	196534	196534	381760	97.12	389890	462	0.12	7286	6021
07a_03	07a	3868567	0	70217	0	3860440	99.79	3798350	1899175	1899175	3692996	97.23	3787212	3011	0.08	84242	70934
07a_04	07a	13862764	0	204612	0	13831223	99.77	13658152	6829076	6829076	13380818	97.97	13616056	10555	0.08	212120	160793
07a_05	07a	422515	0	9703	0	421566	99.78	412812	206406	206406	397038	96.18	411468	395	0.10	12470	11246
07a_06	07a	138703	0	4063	0	138414	99.79	134640	67320	67320	128676	95.57	134156	195	0.14	5176	4626
07a_07	07a	2929727	0	61637	0	2921890	99.73	2868090	1434045	1434045	2783056	97.04	2857940	2313	0.08	68156	57358
07a_08	07a	1377368	0	33128	0	1373911	99.75	1344240	672120	672120	1299772	96.69	1339224	1559	0.12	36370	30119
07a_09	07a	967998	0	19204	0	965524	99.74	948794	474397	474397	920816	97.05	945458	862	0.09	23060	19763
07a_10	07a	430874	0	8904	0	430099	99.82	421970	210985	210985	408282	96.76	420840	355	0.08	11556	10259
07a_11	07a	8325052	0	115944	0	8312181	99.85	8209108	4104554	4104554	8058736	98.17	8191046	5191	0.06	119848	90207
07a_12	07a	3042001	0	67061	0	3033926	99.73	2974940	1487470	1487470	2878612	96.76	2964268	2597	0.09	76376	65641
07a_13	07a	9893318	0	192104	0	9872705	99.79	9701214	4850607	4850607	9443666	97.35	9673790	6811	0.07	211656	172656
07a_14	07a	591216	0	11226	0	589822	99.76	579990	289995	289995	562960	97.06	578028	568	0.10	13690	11423
07a_15	07a	213080	0	6168	0	212690	99.82	206912	103456	103456	196522	94.98	206256	266	0.13	9068	8192
07a_16	07a	855877	0	22605	0	854353	99.82	833272	416636	416636	799196	95.91	830898	850	0.10	28440	23587
07a_17	07a	4888	0	460	0	4680	95.74	4428	2214	2214	2230	50.36	4030	190	4.29	1724	1531
07a_18	07a	56374	0	1084	0	56216	99.72	55290	27645	27645	53864	97.42	55062	70	0.13	1190	1024
07a_19	07a	593800	0	9852	0	592750	99.82	583948	291974	291974	571210	97.82	582380	518	0.09	10426	8272
07a_20	07a	208066	0	4838	0	207488	99.72	203228	101614	101614	196226	96.55	202396	254	0.12	5492	4698
07a_21	07a	2411298	0	52262	0	2405359	99.75	2359036	1179518	1179518	2283210	96.79	2351338	1759	0.07	60926	51413
07a_22	07a	1138464	0	24342	0	1134687	99.67	1114122	557061	557061	1076728	96.64	1109240	1105	0.10	29512	24018
07a_23	07a	610697	0	12109	0	609819	99.86	598588	299294	299294	580796	97.03	597218	492	0.08	15068	12328
07a_24	07a	219385	0	4215	0	218144	99.43	215170	107585	107585	206642	96.04	213294	635	0.30	6284	5180
07a_25	07a	1835782	0	36842	0	1832162	99.80	1798940	899470	899470	1742480	96.86	1793712	1608	0.09	45342	37626
07a_26	07a	875015	0	21541	0	873097	99.78	853474	426737	426737	824624	96.62	850732	824	0.10	24060	20460
07a_27	07a	1004258	0	19192	0	1002025	99.78	985066	492533	492533	955234	96.97	981914	919	0.09	22932	19605
07a_28	07a	3536836	0	75556	0	3528884	99.78	3461280	1730640	1730640	3355212	96.94	3450642	2686	0.08	86346	70892
07a_29	07a	312199	0	5249	0	311621	99.81	306950	153475	153475	298088	97.11	306090	282	0.09	7024	6145
07a_30	07a	125431	0	2285	0	124867	99.55	123146	61573	61573	119348	96.92	122304	278	0.23	2750	2279
07a_31	07a	32681858	0	578082	0	32608505	99.78	32103776	16051888	16051888	31291808	97.47	31998908	31515	0.10	637500	527770
07a_32	07a	2367712	0	41556	0	2360457	99.69	2326156	1163078	1163078	2273748	97.75	2316920	1981	0.09	39470	32461
07a_33	07a	3002677	0	45887	0	2996784	99.80	2956790	1478395	1478395	2887962	97.67	2948654	2243	0.08	51470	41689
07a_34	07a	1424761	0	26421	0	1420435	99.70	1398340	699170	699170	1359880	97.25	1392816	1198	0.09	28560	23512
07a_35	07a	1131522	0	18748	0	1129620	99.83	1112774	556387	556387	1085410	97.54	1110092	780	0.07	21742	17936
07a_36	07a	8100173	0	113851	0	8081774	99.77	7986322	3993161	3993161	7837090	98.13	7962948	4975	0.06	115156	86896
07a_37	07a	28244	0	688	0	28128	99.59	27556	13778	13778	25826	93.72	27336	104	0.38	1212	1136
07a_38	07a	1562527	0	27465	0	1559547	99.81	1535062	767531	767531	1491658	97.17	1530722	1360	0.09	35144	29461
07a_39	07a	315716	0	5880	0	315161	99.82	309836	154918	154918	302248	97.55	308980	301	0.10	5702	4420
07a_40	07a	160801	0	2565	0	160373	99.73	158236	79118	79118	154134	97.41	157668	140	0.09	3216	2645
07a_41	07a	2621903	0	38497	0	2609999	99.55	2583406	1291703	1291703	2526878	97.81	2569518	1984	0.08	38346	31395
07a_42	07a	37799	0	473	0	37538	99.31	37326	18663	18663	35910	96.21	36986	79	0.21	1026	916
07a_43	07a	1352435	0	20155	0	1348136	99.68	1332280	666140	666140	1303254	97.82	1326864	1117	0.08	21264	15881
07a_44	07a	1362482	0	21302	0	1359137	99.75	1341180	670590	670590	1309670	97.65	1337010	825	0.06	23972	19611
07a_45	07a	1464657	0	19549	0	1458251	99.56	1445108	722554	722554	1414666	97.89	1437368	1334	0.09	20412	16021
07a_46	07a	571669	0	10867	0	569513	99.62	560802	280401	280401	543252	96.87	557972	674	0.12	13792	11835
07a_48	07a	39781	0	797	0	39399	99.04	38984	19492	19492	36998	94.91	38454	148	0.38	1426	1256
07a_49	07a	2307846	0	31920	0	2298448	99.59	2275926	1137963	1137963	2225198	97.77	2263176	3352	0.15	33722	26465
07a_50	07a	69648	0	886	0	69280	99.47	68762	34381	34381	66280	96.39	68116	278	0.40	1568	1382
08ab_01	08ab	29008	0	72	0	5993	20.66	28936	14468	14468	4344	15.01	5180	741	2.56	790	671
08ab_02	08ab	55577	0	329	0	41548	74.76	55248	27624	27624	38632	69.92	40462	757	1.37	1764	1364
08ab_03	08ab	236250	0	2484	0	200517	84.87	233766	116883	116883	194188	83.07	196986	1047	0.45	2714	1725
08ab_04	08ab	177449	0	845	0	101658	57.29	176604	88302	88302	98124	55.56	99440	1373	0.78	1242	985
08ab_05	08ab	312622	0	1670	0	207610	66.41	310952	155476	155476	202848	65.23	205034	906	0.29	1774	1329
08ab_06	08ab	1862023	0	15245	0	1811518	97.29	1846778	923389	923389	1779832	96.37	1792740	3533	0.19	11354	7290
08ab_07	08ab	166053	0	513	0	73672	44.37	165540	82770	82770	71562	43.23	72084	1075	0.65	492	312
08ab_08	08ab	123451	0	287	0	56005	45.37	123164	61582	61582	54236	44.04	55074	644	0.52	766	609
08ab_09	08ab	17851	0	155	0	3834	21.48	17696	8848	8848	2052	11.60	3174	505	2.85	582	477
08ab_10	08ab	130391	0	753	0	67114	51.47	129638	64819	64819	64190	49.51	65354	1007	0.78	1144	601
08ab_11	08ab	640384	0	2290	0	280501	43.80	638094	319047	319047	265594	41.62	269692	8519	1.34	3892	1409
08ab_12	08ab	235118	0	2388	0	101119	43.01	232730	116365	116365	90806	39.02	93506	5225	2.25	2388	1055
08ab_13	08ab	424726	0	2750	0	287838	67.77	421976	210988	210988	279532	66.24	283730	1358	0.32	3882	2843
08ab_14	08ab	311528	0	2196	0	164398	52.77	309332	154666	154666	156340	50.54	160306	1896	0.61	3802	2353
08ab_15	08ab	173578	0	784	0	77405	44.59	172794	86397	86397	75028	43.42	76214	407	0.24	1134	540
08ab_16	08ab	32919	0	157	0	19597	59.53	32762	16381	16381	18640	56.90	19234	206	0.63	574	475
08ab_17	08ab	101732	0	602	0	65589	64.47	101130	50565	50565	62570	61.87	63350	1637	1.62	750	335
08ab_18	08ab	254129	0	2213	0	201399	79.25	251916	125958	125958	195574	77.63	198206	980	0.39	2094	1382
08ab_19	08ab	133259	0	305	0	49822	37.39	132954	66477	66477	46474	34.95	47712	1805	1.36	1168	277
08ab_20	08ab	1537627	0	15455	0	1156889	75.24	1522172	761086	761086	1122450	73.74	1136414	5020	0.33	13134	9113
08ab_21	08ab	142813	0	1997	0	92157	64.53	140816	70408	70408	86440	61.39	88944	1216	0.86	2404	1551
08ab_22	08ab	1236696	0	8016	0	727374	58.82	1228680	614340	614340	703772	57.28	712392	6966	0.57	7994	4391
08ab_23	08ab	190407	0	883	0	92790	48.73	189524	94762	94762	86514	45.65	89112	2795	1.47	2524	1464
08ab_24	08ab	309229	0	2515	0	245704	79.46	306714	153357	153357	239754	78.17	242724	465	0.15	2916	2252
08ab_25	08ab	848656	0	10072	0	804783	94.83	838584	419292	419292	782606	93.32	791858	2853	0.34	8408	6269
08ab_26	08ab	914613	0	6183	0	583528	63.80	908430	454215	454215	557910	61.41	567122	10223	1.13	8780	3433
08ab_27	08ab	2233055	0	55645	0	2183044	97.76	2177410	1088705	1088705	2071670	95.14	2124986	2413	0.11	48924	41054
08ab_28	08ab	7820686	0	181112	0	7779954	99.48	7639574	3819787	3819787	7412170	97.02	7591962	6880	0.09	166322	138221
08ab_29	08ab	2683697	0	25403	0	1896897	70.68	2658294	1329147	1329147	1833028	68.96	1862082	9412	0.35	24182	17716
08ab_30	08ab	738619	0	10203	0	702853	95.16	728416	364208	364208	680372	93.40	690526	2124	0.29	8970	5782
08ab_31	08ab	1739035	0	21579	0	1659560	95.43	1717456	858728	858728	1617508	94.18	1636234	1747	0.10	17266	13369
08ab_32	08ab	196506	0	2236	0	172594	87.83	194270	97135	97135	167818	86.38	169428	930	0.48	1522	917
08ab_33	08ab	510356	0	2454	0	295516	57.90	507902	253951	253951	289256	56.95	292142	920	0.18	2164	1430
08ab_34	08ab	842336	0	9168	0	773768	91.86	833168	416584	416584	755380	90.66	763180	1420	0.17	6846	5275
08ab_35	08ab	2783075	0	31601	0	2056199	73.88	2751474	1375737	1375737	1989670	72.31	2015636	8962	0.33	23000	17824
08ab_36	08ab	1781391	0	23545	0	1661286	93.26	1757846	878923	878923	1614900	91.87	1635082	2659	0.15	17386	11881
08ab_37	08ab	1086824	0	21818	0	966949	88.97	1065006	532503	532503	921354	86.51	940622	4509	0.42	18170	13612
08ab_39	08ab	360031	0	3673	0	261996	72.77	356358	178179	178179	253018	71.00	256924	1399	0.39	3172	2420
08ab_40	08ab	1688544	0	23312	0	1617556	95.80	1665232	832616	832616	1569758	94.27	1592220	2024	0.12	21070	15347
08ab_41	08ab	301144	0	730	0	116704	38.75	300414	150207	150207	113596	37.81	115202	772	0.26	1276	732
08ab_42	08ab	1812295	0	18409	0	1788993	98.71	1793886	896943	896943	1755416	97.86	1769516	1068	0.06	12802	9235
08ab_43	08ab	1726840	0	12764	0	1221518	70.74	1714076	857038	857038	1187144	69.26	1198588	10166	0.59	9884	5627
08ab_44	08ab	196316	0	1992	0	122659	62.48	194324	97162	97162	118012	60.73	119200	1467	0.75	1142	904
08ab_45	08ab	2181005	0	34855	0	1774220	81.35	2146150	1073075	1073075	1692292	78.85	1728234	11131	0.52	32210	22679
08ab_46	08ab	12842992	0	186662	0	12627993	98.33	12656330	6328165	6328165	12271732	96.96	12431134	10197	0.08	140240	111121
08ab_47	08ab	2091983	0	41449	0	1860042	88.91	2050534	1025267	1025267	1766190	86.13	1812884	5709	0.28	42468	36997
08ab_49	08ab	4600224	0	90656	0	4105150	89.24	4509568	2254784	2254784	3902054	86.53	3995228	19266	0.43	82382	61803
08ab_50	08ab	2661158	0	32440	0	2623915	98.60	2628718	1314359	1314359	2562822	97.49	2588232	3243	0.12	23566	18774
09a_04	09a	143807	0	1435	0	101484	70.57	142372	71186	71186	95420	67.02	99150	899	0.63	3514	2972
09a_05	09a	689436	0	6112	0	452842	65.68	683324	341662	341662	438596	64.19	445256	1474	0.22	5752	4374
09a_07	09a	387017	0	3911	0	371274	95.93	383106	191553	191553	362012	94.49	366810	553	0.14	4234	3434
09a_08	09a	53194	0	746	0	44714	84.06	52448	26224	26224	41952	79.99	43564	404	0.77	1518	1327
09a_10	09a	4776680	0	58284	0	3872191	81.06	4718396	2359198	2359198	3733884	79.13	3800250	13657	0.29	58994	48626
09a_14	09a	9988268	0	99866	0	9381328	93.92	9888402	4944201	4944201	9200596	93.04	9270994	10468	0.11	61676	45899
09a_15	09a	289625	0	3311	0	284377	98.19	286314	143157	143157	274906	96.02	280212	854	0.30	4588	3768
09a_17	09a	1743829	0	10057	0	998229	57.24	1733772	866886	866886	978594	56.44	985422	2750	0.16	5998	4210
09a_18	09a	3700741	0	43947	0	2880198	77.83	3656794	1828397	1828397	2790418	76.31	2828380	7871	0.22	33496	26970
09a_28	09a	625440	0	7004	0	619118	98.99	618436	309218	309218	604638	97.77	611392	722	0.12	5990	4805
09a_31	09a	194736	0	4682	0	192332	98.77	190054	95027	95027	181976	95.75	187146	504	0.27	4770	4034
09a_32	09a	595119	0	5933	0	444414	74.68	589186	294593	294593	432130	73.34	437442	1039	0.18	4950	4050
09a_39	09a	346904	0	2162	0	198974	57.36	344742	172371	172371	191672	55.60	195544	1268	0.37	3562	3103
09a_43	09a	19164	0	280	0	8585	44.80	18884	9442	9442	7016	37.15	8118	187	0.99	1036	918
09a_44	09a	109967	0	1383	0	107117	97.41	108584	54292	54292	103914	95.70	105454	280	0.26	1452	1131
09a_50	09a	3257185	0	17191	0	2101848	64.53	3239994	1619997	1619997	2065542	63.75	2079616	5041	0.16	12394	8890
09b_01	09b	25324	0	664	0	25215	99.57	24660	12330	12330	23542	95.47	24450	101	0.41	864	753
09b_02	09b	34658306	0	344502	0	34521566	99.61	34313804	17156902	17156902	33672254	98.13	34129738	47326	0.14	391464	316833
09b_03	09b	4851047	0	48943	0	4835017	99.67	4802104	2401052	2401052	4717164	98.23	4780532	5542	0.12	52334	36705
09b_04	09b	33955	0	789	0	31651	93.21	33166	16583	16583	27060	81.59	30120	742	2.24	2948	2708
09b_05	09b	3311559	0	33661	0	3264815	98.59	3277898	1638949	1638949	3182616	97.09	3225338	5816	0.18	32786	22631
09b_06	09b	512744	0	5678	0	502745	98.05	507066	253533	253533	485690	95.78	495184	1883	0.37	9002	7194
09b_07	09b	150923	0	1947	0	149618	99.14	148976	74488	74488	144368	96.91	147220	451	0.30	2748	2210
09b_08	09b	2969150	0	25546	0	2946492	99.24	2943604	1471802	1471802	2882384	97.92	2917532	3414	0.12	29526	19576
09b_09	09b	369683	0	3661	0	365685	98.92	366022	183011	183011	357700	97.73	361722	302	0.08	3740	2736
09b_10	09b	528609	0	4639	0	522009	98.75	523970	261985	261985	511116	97.55	516558	812	0.15	4874	4110
09b_11	09b	29399	0	751	0	28669	97.52	28648	14324	14324	26038	90.89	27768	150	0.52	1708	1473
09b_12	09b	753264	0	6628	0	727964	96.64	746636	373318	373318	711560	95.30	720392	944	0.13	7744	5409
09b_13	09b	88645	0	981	0	87991	99.26	87664	43832	43832	83634	95.40	86794	216	0.25	3130	2640
09b_14	09b	3601755	0	36045	0	3584246	99.51	3565710	1782855	1782855	3503790	98.26	3544444	3757	0.11	33280	24456
09b_15	09b	263549	0	3039	0	259852	98.60	260510	130255	130255	251368	96.49	255806	1007	0.39	3938	3455
09b_16	09b	709937	0	4113	0	700080	98.61	705824	352912	352912	689754	97.72	694858	1109	0.16	4580	3588
09b_17	09b	1560328	0	13334	0	1549460	99.30	1546994	773497	773497	1517218	98.08	1532922	3204	0.21	14010	10466
09b_18	09b	419998	0	3962	0	418285	99.59	416036	208018	208018	407762	98.01	413662	661	0.16	5128	4052
09b_19	09b	3659676	0	38130	0	3640552	99.48	3621546	1810773	1810773	3543064	97.83	3596626	5796	0.16	44676	37763
09b_20	09b	1176431	0	16419	0	1165887	99.10	1160012	580006	580006	1127774	97.22	1147770	1698	0.15	18384	15423
09b_21	09b	172657	0	2303	0	171186	99.15	170354	85177	85177	164636	96.64	168462	421	0.25	2890	2451
09b_22	09b	1711997	0	17243	0	1688368	98.62	1694754	847377	847377	1650172	97.37	1668894	2231	0.13	14432	10351
09b_23	09b	919296	0	12430	0	916136	99.66	906866	453433	453433	882414	97.30	902010	1696	0.19	16468	12093
09b_24	09b	136476	0	996	0	132807	97.31	135480	67740	67740	130586	96.39	131702	109	0.08	1082	835
09b_25	09b	1091097	0	9137	0	1085885	99.52	1081960	540980	540980	1065066	98.44	1075944	804	0.07	9432	7886
09b_26	09b	678502	0	9218	0	672614	99.13	669284	334642	334642	647966	96.81	662428	968	0.14	13168	11298
09b_27	09b	1002725	0	9767	0	979233	97.66	992958	496479	496479	955800	96.26	968124	1342	0.14	9970	7350
09b_28	09b	53503	0	1267	0	47416	88.62	52236	26118	26118	41038	78.56	44266	1883	3.60	2856	2546
09b_29	09b	3172809	0	41049	0	3155943	99.47	3131760	1565880	1565880	3062082	97.78	3110986	3908	0.12	44062	33217
09b_30	09b	580996	0	5872	0	575698	99.09	575124	287562	287562	562804	97.86	568590	1236	0.21	4804	3939
09b_31	09b	1115246	0	13426	0	1109229	99.46	1101820	550910	550910	1077076	97.75	1094254	1549	0.14	15442	9247
09b_32	09b	1342735	0	12819	0	1319050	98.24	1329916	664958	664958	1289010	96.92	1304856	1375	0.10	12934	9022
09b_33	09b	671847	0	7309	0	666181	99.16	664538	332269	332269	648954	97.65	658138	734	0.11	7796	5121
09b_34	09b	382727	0	4507	0	379708	99.21	378220	189110	189110	367116	97.06	374770	431	0.11	6844	6100
09b_35	09b	239637	0	3487	0	238203	99.40	236150	118075	118075	228538	96.78	234512	204	0.09	5098	3698
09b_36	09b	863650	0	7702	0	856175	99.13	855948	427974	427974	841534	98.32	847500	973	0.11	5320	4028
09b_37	09b	4224174	0	43020	0	4189225	99.17	4181154	2090577	2090577	4096420	97.97	4142126	4079	0.10	40648	28336
09b_38	09b	412608	0	3356	0	407996	98.88	409252	204626	204626	399402	97.59	403966	674	0.16	3350	2541
09b_39	09b	523819	0	5801	0	518696	99.02	518018	259009	259009	506532	97.78	511920	975	0.19	4822	3677
09b_40	09b	2809281	0	26423	0	2790403	99.33	2782858	1391429	1391429	2730746	98.13	2760308	3672	0.13	25354	16289
09b_41	09b	47858	0	700	0	47310	98.85	47158	23579	23579	43634	92.53	46380	230	0.49	2672	1966
09b_42	09b	1256704	0	11702	0	1249090	99.39	1245002	622501	622501	1222336	98.18	1235704	1684	0.14	12018	9131
09b_43	09b	461541	0	4193	0	458072	99.25	457348	228674	228674	445676	97.45	453340	539	0.12	5870	4472
09b_44	09b	79990	0	1320	0	79718	99.66	78670	39335	39335	76112	96.75	78146	252	0.32	2006	1558
09b_45	09b	1678791	0	17075	0	1667985	99.36	1661716	830858	830858	1632572	98.25	1648994	1916	0.12	13358	10057
09b_46	09b	13934	0	516	0	13267	95.21	13418	6709	6709	10662	79.46	12514	237	1.77	1788	1697
09b_47	09b	3814960	0	35362	0	3792278	99.41	3779598	1889799	1889799	3716784	98.34	3752022	4894	0.13	28182	17706
09b_48	09b	48732	0	810	0	48639	99.81	47922	23961	23961	47402	98.91	47754	75	0.16	350	305
09b_49	09b	21850	0	406	0	20615	94.35	21444	10722	10722	19418	90.55	20150	59	0.28	684	632
09b_50	09b	14068	0	514	0	10046	71.41	13554	6777	6777	6528	48.16	8944	588	4.34	2328	2054
10a_01	10a	586730	0	8628	0	584044	99.54	578102	289051	289051	566168	97.94	574378	1038	0.18	7550	6387
10a_02	10a	1582012	0	34696	0	1573516	99.46	1547316	773658	773658	1500756	96.99	1536630	2190	0.14	32276	26592
10a_03	10a	2769348	0	62738	0	2761488	99.72	2706610	1353305	1353305	2631174	97.21	2696796	1954	0.07	59320	50694
10a_04	10a	1536182	0	35394	0	1531383	99.69	1500788	750394	750394	1454166	96.89	1494244	1745	0.12	36370	29522
10a_05	10a	548057	0	16127	0	545368	99.51	531930	265965	265965	512870	96.42	528588	653	0.12	14638	12459
10a_06	10a	4281481	0	71151	0	4268569	99.70	4210330	2105165	2105165	4128726	98.06	4193964	3454	0.08	59586	46209
10a_07	10a	925218	0	9732	0	918428	99.27	915486	457743	457743	896786	97.96	907252	1444	0.16	9062	6128
10a_08	10a	1906966	0	37596	0	1901356	99.71	1869370	934685	934685	1823198	97.53	1861856	1904	0.10	34150	28794
10a_09	10a	6202042	0	115246	0	6185836	99.74	6086796	3043398	3043398	5946802	97.70	6065508	5082	0.08	104604	84512
10a_10	10a	404030	0	12682	0	402338	99.58	391348	195674	195674	376426	96.19	389154	502	0.13	11786	10014
10a_11	10a	3216521	0	81677	0	3207108	99.71	3134844	1567422	1567422	3036928	96.88	3121976	3455	0.11	77712	67505
10a_12	10a	2888443	0	74853	0	2879762	99.70	2813590	1406795	1406795	2729652	97.02	2801862	3047	0.11	65616	54859
10a_13	10a	5198852	0	120474	0	5183996	99.71	5078378	2539189	2539189	4941118	97.30	5059218	4304	0.08	107728	84692
10a_14	10a	2497438	0	55528	0	2488085	99.63	2441910	1220955	1220955	2377680	97.37	2429940	2617	0.11	46600	38313
10a_17	10a	4608128	0	86456	0	4596350	99.74	4521672	2260836	2260836	4413100	97.60	4505472	4422	0.10	83946	69654
10a_20	10a	4200046	0	88724	0	4191802	99.80	4111322	2055661	2055661	4003106	97.37	4098980	4098	0.10	86724	70710
10a_21	10a	7134462	0	98344	0	7113094	99.70	7036118	3518059	3518059	6915282	98.28	7009378	5372	0.08	83696	67042
10a_22	10a	1000958	0	32854	0	998046	99.71	968104	484052	484052	929228	95.98	964276	916	0.09	32076	27817
10a_23	10a	822603	0	17253	0	819654	99.64	805350	402675	402675	778974	96.72	801388	1013	0.13	20040	16318
10a_24	10a	6134285	0	124289	0	6112061	99.64	6009996	3004998	3004998	5870916	97.69	5982284	5488	0.09	99704	81173
10a_25	10a	1044850	0	32314	0	1041469	99.68	1012536	506268	506268	975410	96.33	1008086	1069	0.11	29694	26624
10a_28	10a	1740333	0	45731	0	1735120	99.70	1694602	847301	847301	1639944	96.77	1687400	1989	0.12	41744	34202
10a_31	10a	2691368	0	75752	0	2681686	99.64	2615616	1307808	1307808	2521974	96.42	2603390	2544	0.10	74770	64423
10a_33	10a	3069134	0	69740	0	3059078	99.67	2999394	1499697	1499697	2915886	97.22	2985856	3482	0.12	63720	52038
10a_34	10a	1371756	0	37718	0	1366680	99.63	1334038	667019	667019	1285418	96.36	1327188	1774	0.13	37828	32374
10a_36	10a	3933452	0	96970	0	3920549	99.67	3836482	1918241	1918241	3716924	96.88	3818836	4743	0.12	91102	76450
10a_37	10a	2907776	0	79160	0	2898925	99.70	2828616	1414308	1414308	2733636	96.64	2817042	2723	0.10	75452	65812
10a_39	10a	314286	0	9060	0	311899	99.24	305226	152613	152613	292710	95.90	302310	529	0.17	8898	7780
10a_40	10a	8041321	0	236387	0	8019800	99.73	7804934	3902467	3902467	7527394	96.44	7775882	7531	0.10	231098	197761
10a_41	10a	1320857	0	29607	0	1315899	99.62	1291250	645625	645625	1255106	97.20	1284900	1392	0.11	26396	22076
10a_43	10a	33750677	0	567955	0	33660035	99.73	33182722	16591361	16591361	32579584	98.18	33064734	27346	0.08	431296	357272
10a_44	10a	17403098	0	331410	0	17354636	99.72	17071688	8535844	8535844	16709496	97.88	17007386	15840	0.09	271022	221613
10a_48	10a	5539712	0	111940	0	5525895	99.75	5427772	2713886	2713886	5281598	97.31	5407970	5985	0.11	115126	98774
10bc_01	10bc	72514	0	160	0	22493	31.02	72354	36177	36177	20752	28.68	21654	679	0.94	866	732
10bc_02	10bc	5664735	0	52233	0	5633043	99.44	5612502	2806251	2806251	5529904	98.53	5576890	3920	0.07	40512	30143
10bc_03	10bc	1693792	0	13688	0	1640258	96.84	1680104	840052	840052	1615386	96.15	1624300	2270	0.14	8490	5614
10bc_04	10bc	1519203	0	12521	0	1323051	87.09	1506682	753341	753341	1295118	85.96	1305200	5330	0.35	9366	5187
10bc_05	10bc	19648786	0	196426	0	19539589	99.44	19452360	9726180	9726180	19182544	98.61	19326506	16657	0.09	130550	88271
10bc_06	10bc	51417155	0	483535	0	51091310	99.37	50933620	25466810	25466810	50163824	98.49	50553340	54435	0.11	272278	181225
10bc_07	10bc	223016	0	1374	0	148029	66.38	221642	110821	110821	141432	63.81	144704	1951	0.88	3064	1945
10bc_08	10bc	3260173	0	33071	0	3230917	99.10	3227102	1613551	1613551	3168676	98.19	3194908	2938	0.09	23032	15354
10bc_09	10bc	633644	0	6806	0	564094	89.02	626838	313419	313419	549054	87.59	555672	1616	0.26	5184	4296
10bc_10	10bc	4266410	0	55928	0	4173271	97.82	4210482	2105241	2105241	4069602	96.65	4114576	2767	0.07	38434	27613
10bc_11	10bc	547687	0	1513	0	94028	17.17	546174	273087	273087	70708	12.95	75098	17417	3.19	3904	866
10bc_12	10bc	2801290	0	53460	0	2404854	85.85	2747830	1373915	1373915	2283624	83.11	2341448	9946	0.36	50918	41381
10bc_13	10bc	1008772	0	8646	0	648448	64.28	1000126	500063	500063	615520	61.54	629754	10048	1.00	13126	7899
10bc_14	10bc	7179918	0	85408	0	7018996	97.76	7094510	3547255	3547255	6851126	96.57	6925656	7932	0.11	60378	44779
10bc_15	10bc	887316	0	11504	0	692861	78.09	875812	437906	437906	667482	76.21	676570	4787	0.55	7516	4412
10bc_16	10bc	5621948	0	64368	0	5491678	97.68	5557580	2778790	2778790	5374904	96.71	5419788	7522	0.14	40534	28121
10bc_17	10bc	874132	0	11386	0	760933	87.05	862746	431373	431373	740630	85.85	747086	2461	0.29	5856	4329
10bc_18	10bc	775875	0	11031	0	616192	79.42	764844	382422	382422	588808	76.98	600338	4823	0.63	10932	8656
10bc_19	10bc	3738654	0	51940	0	3590064	96.03	3686714	1843357	1843357	3489568	94.65	3532136	5988	0.16	37748	30207
10bc_20	10bc	1090620	0	24122	0	935481	85.78	1066498	533249	533249	882742	82.77	906876	4483	0.42	22334	18277
10bc_21	10bc	444258	0	7404	0	348522	78.45	436854	218427	218427	330174	75.58	337386	3732	0.85	7078	4961
10bc_22	10bc	6650318	0	94828	0	6590852	99.11	6555490	3277745	3277745	6405358	97.71	6490988	5036	0.08	73524	56349
10bc_23	10bc	681185	0	8461	0	539748	79.24	672724	336362	336362	518768	77.11	526794	4493	0.67	6800	3799
10bc_24	10bc	1875289	0	25545	0	1826174	97.38	1849744	924872	924872	1773266	95.87	1798242	2387	0.13	22688	15718
10bc_25	10bc	2865597	0	34151	0	2733970	95.41	2831446	1415723	1415723	2664880	94.12	2695340	4479	0.16	26532	17803
10bc_26	10bc	608205	0	2117	0	118696	19.52	606088	303044	303044	92394	15.24	98998	17581	2.90	6488	1332
10bc_27	10bc	690855	0	7661	0	521178	75.44	683194	341597	341597	499276	73.08	509252	4265	0.62	9126	5953
10bc_28	10bc	5194055	0	121049	0	4960472	95.50	5073006	2536503	2536503	4702390	92.69	4827526	11897	0.23	114360	91860
10bc_29	10bc	17917113	0	410739	0	17680578	98.68	17506374	8753187	8753187	16848800	96.24	17252090	17749	0.10	358676	297679
10bc_30	10bc	1886231	0	38607	0	1853794	98.28	1847624	923812	923812	1774880	96.06	1812648	2539	0.14	35230	28091
10bc_31	10bc	1261929	0	23103	0	1202147	95.26	1238826	619413	619413	1151752	92.97	1176858	2186	0.18	22832	17878
10bc_32	10bc	5695694	0	62376	0	5638779	99.00	5633318	2816659	2816659	5515136	97.90	5571646	4757	0.08	50104	37948
10bc_33	10bc	5395357	0	70045	0	5034712	93.32	5325312	2662656	2662656	4890216	91.83	4952552	12115	0.23	51940	38316
10bc_35	10bc	644930	0	5592	0	259617	40.26	639338	319669	319669	236450	36.98	243978	10047	1.57	7078	3329
10bc_36	10bc	1880012	0	31648	0	1353622	72.00	1848364	924182	924182	1272964	68.87	1309338	12636	0.68	33110	25600
10bc_37	10bc	9554556	0	124700	0	9238049	96.69	9429856	4714928	4714928	8974772	95.17	9097798	15551	0.16	112318	85250
10bc_38	10bc	1301753	0	22903	0	1212944	93.18	1278850	639425	639425	1166622	91.22	1186638	3403	0.27	19408	15447
10bc_39	10bc	168659	0	557	0	48617	28.83	168102	84051	84051	43488	25.87	45108	2952	1.76	1552	480
10bc_40	10bc	4535118	0	81308	0	4342310	95.75	4453810	2226905	2226905	4167560	93.57	4252332	8670	0.19	75010	60188
10bc_41	10bc	6655707	0	86931	0	6524285	98.03	6568776	3284388	3284388	6357060	96.78	6428432	8922	0.14	63990	47419
10bc_42	10bc	2249043	0	35311	0	2170515	96.51	2213732	1106866	1106866	2098814	94.81	2132428	2776	0.13	30412	23831
10bc_44	10bc	2880968	0	38782	0	2341497	81.27	2842186	1421093	1421093	2245436	79.00	2284232	18483	0.65	35872	26549
10bc_45	10bc	7768956	0	132734	0	7487775	96.38	7636222	3818111	3818111	7221026	94.56	7342818	12223	0.16	107648	82459
10bc_46	10bc	1852511	0	29853	0	1267111	68.40	1822658	911329	911329	1180174	64.75	1221034	16224	0.89	38144	28190
10bc_47	10bc	9119868	0	139044	0	8969508	98.35	8980824	4490412	4490412	8699472	96.87	8821966	8498	0.09	105662	81614
10bc_48	10bc	356936	0	2240	0	185053	51.84	354696	177348	177348	173446	48.90	178008	4805	1.35	4498	3277
10bc_49	10bc	40900545	0	488787	0	40752564	99.64	40411758	20205879	20205879	39836466	98.58	40231256	32521	0.08	343976	214790
10bc_50	10bc	34655452	0	332180	0	34258383	98.85	34323272	17161636	17161636	33636642	98.00	33887336	38867	0.11	226442	159019
10bc_51	10bc	1494769	0	21749	0	1343377	89.87	1473020	736510	736510	1295700	87.96	1318570	3058	0.21	20650	17122
10bc_52	10bc	1517638	0	22530	0	1388292	91.48	1495108	747554	747554	1346426	90.06	1362590	3172	0.21	13968	9530
10bc_53	10bc	1421529	0	11815	0	618078	43.48	1409714	704857	704857	558864	39.64	575606	30657	2.17	15414	7878
10bc_57	10bc	27997586	0	441694	0	27480852	98.15	27555892	13777946	13777946	26629054	96.64	27006548	32610	0.12	339124	260926
11ab_01	11ab	1424138	0	21680	0	1274702	89.51	1402458	701229	701229	1231726	87.83	1250070	2952	0.21	16894	13717
11ab_02	11ab	112366	0	1234	0	97332	86.62	111132	55566	55566	93356	84.00	95616	482	0.43	2088	1776
11ab_03	11ab	3385727	0	39535	0	3344953	98.80	3346192	1673096	1673096	3271550	97.77	3302028	3390	0.10	27204	16734
11ab_04	11ab	1039080	0	12994	0	1029726	99.10	1026086	513043	513043	1004910	97.94	1015642	1090	0.11	9582	6981
11ab_05	11ab	1881148	0	23816	0	1864374	99.11	1857332	928666	928666	1817560	97.86	1838636	1922	0.10	18852	13202
11ab_06	11ab	505618	0	6748	0	500324	98.95	498870	249435	249435	485790	97.38	492864	712	0.14	6372	4761
11ab_07	11ab	2756249	0	29927	0	2736280	99.28	2726322	1363161	1363161	2676656	98.18	2704016	2337	0.09	23734	18145
11ab_08	11ab	15183	0	345	0	14440	95.11	14838	7419	7419	12616	85.02	13830	265	1.79	1168	1055
11ab_09	11ab	217564	0	3660	0	210366	96.69	213904	106952	106952	201496	94.20	206180	526	0.25	4238	3590
11ab_10	11ab	902161	0	24103	0	892617	98.94	878058	439029	439029	842204	95.92	866878	1636	0.19	22980	18626
11ab_12	11ab	1486985	0	18677	0	1465782	98.57	1468308	734154	734154	1431596	97.50	1445674	1431	0.10	12524	8738
11ab_13	11ab	70101	0	1019	0	68382	97.55	69082	34541	34541	65104	94.24	67076	287	0.42	1824	1551
11ab_14	11ab	371327	0	6179	0	368956	99.36	365148	182574	182574	356230	97.56	362312	465	0.13	5524	4362
11ab_15	11ab	123095	0	2083	0	113260	92.01	121012	60506	60506	108268	89.47	110708	469	0.39	2294	1700
11ab_16	11ab	2782619	0	45063	0	2742576	98.56	2737556	1368778	1368778	2661560	97.22	2694900	2613	0.10	30220	23081
11ab_17	11ab	4067296	0	59054	0	3982417	97.91	4008242	2004121	2004121	3867814	96.50	3919442	3921	0.10	45386	33822
11ab_19	11ab	2671899	0	55959	0	2651719	99.24	2615940	1307970	1307970	2543004	97.21	2593502	2258	0.09	45342	35845
11ab_20	11ab	675060	0	8656	0	661554	98.00	666404	333202	333202	644362	96.69	652314	584	0.09	6652	5217
11ab_21	11ab	2901929	0	46517	0	2873000	99.00	2855412	1427706	1427706	2785992	97.57	2823542	2941	0.10	32258	26044
11ab_23	11ab	737979	0	10501	0	697347	94.49	727478	363739	363739	674596	92.73	685794	1052	0.14	10224	7469
11ab_24	11ab	181542	0	2726	0	175879	96.88	178816	89408	89408	168870	94.44	172776	377	0.21	3560	2723
11ab_25	11ab	497446	0	6416	0	440042	88.46	491030	245515	245515	423060	86.16	431870	1756	0.36	8068	6989
11ab_26	11ab	1984208	0	26768	0	1904408	95.98	1957440	978720	978720	1850116	94.52	1875740	1900	0.10	22146	15870
11ab_27	11ab	587539	0	5165	0	574866	97.84	582374	291187	291187	563684	96.79	569072	629	0.11	4840	3678
11ab_28	11ab	538988	0	7266	0	529226	98.19	531722	265861	265861	514646	96.79	521204	756	0.14	5988	4648
11ab_29	11ab	226836	0	3382	0	215061	94.81	223454	111727	111727	207046	92.66	211026	653	0.29	3636	2988
11ab_31	11ab	150339	0	1365	0	123991	82.47	148974	74487	74487	119904	80.49	122130	496	0.33	2100	1654
11ab_32	11ab	1548921	0	18937	0	1221689	78.87	1529984	764992	764992	1183014	77.32	1199176	3576	0.23	14778	11944
11ab_33	11ab	1932472	0	18822	0	1654102	85.60	1913650	956825	956825	1612448	84.26	1632588	2692	0.14	18534	13281
11ab_34	11ab	1252566	0	14024	0	1105312	88.24	1238542	619271	619271	1076398	86.91	1089700	1588	0.13	11656	8328
11ab_35	11ab	358470	0	4954	0	351574	98.08	353516	176758	176758	341280	96.54	345958	662	0.19	3974	2990
11ab_36	11ab	1735195	0	22821	0	1629417	93.90	1712374	856187	856187	1583910	92.50	1604562	2034	0.12	19294	14825
11ab_37	11ab	158020	0	1444	0	137969	87.31	156576	78288	78288	133116	85.02	135864	661	0.42	2654	2208
11ab_38	11ab	1584870	0	12478	0	1232922	77.79	1572392	786196	786196	1207082	76.77	1218346	2098	0.13	10302	7691
11ab_39	11ab	167207	0	1557	0	138991	83.13	165650	82825	82825	134426	81.15	136848	586	0.35	2200	1842
11ab_41	11ab	1005832	0	12462	0	981145	97.55	993370	496685	496685	957366	96.38	967510	1173	0.12	9350	6823
11ab_42	11ab	1716757	0	23909	0	1471439	85.71	1692848	846424	846424	1418866	83.82	1443842	3688	0.22	22178	17004
11ab_44	11ab	130788	0	1604	0	108818	83.20	129184	64592	64592	104130	80.61	106742	472	0.37	2504	2134
11ab_46	11ab	5149108	0	61734	0	4774331	92.72	5087374	2543687	2543687	4646968	91.34	4706758	5839	0.11	53664	39208
11ab_47	11ab	185999	0	1473	0	151613	81.51	184526	92263	92263	147146	79.74	149692	448	0.24	2284	1736
11ab_48	11ab	1209879	0	14505	0	1186804	98.09	1195374	597687	597687	1156388	96.74	1170944	1355	0.11	13108	10007
11ab_49	11ab	3753831	0	52735	0	3732966	99.44	3701096	1850548	1850548	3621644	97.85	3676896	3335	0.09	45994	36106
11ab_50	11ab	3348522	0	30772	0	3033373	90.59	3317750	1658875	1658875	2973514	89.62	2999092	3509	0.11	21280	14653
11c_01	11c	394909	0	4935	0	378153	95.76	389974	194987	194987	360380	92.41	371838	1380	0.35	10402	9059
11c_03	11c	41143318	0	443792	0	40956731	99.55	40699526	20349763	20349763	39777070	97.73	40450726	62213	0.15	587636	420525
11c_04	11c	9862513	0	84453	0	9812418	99.49	9778060	4889030	4889030	9606226	98.24	9712840	15125	0.15	98816	66332
11c_05	11c	17875027	0	175245	0	17805666	99.61	17699782	8849891	8849891	17411446	98.37	17608488	21933	0.12	156204	103586
11c_06	11c	2618146	0	29592	0	2606037	99.54	2588554	1294277	1294277	2524126	97.51	2573262	3183	0.12	43940	28980
11c_07	11c	4560282	0	39154	0	4542735	99.62	4521128	2260564	2260564	4447984	98.38	4497412	6169	0.14	39944	23292
11c_08	11c	360965	0	3205	0	358457	99.31	357760	178880	178880	350382	97.94	354686	566	0.16	4124	2620
11c_09	11c	707310	0	10630	0	703631	99.48	696680	348340	348340	676030	97.04	691362	1639	0.24	13638	11295
11c_10	11c	689406	0	8792	0	685059	99.37	680614	340307	340307	663840	97.54	674998	1269	0.19	9900	7045
11c_11	11c	7345066	0	90052	0	7309215	99.51	7255014	3627507	3627507	7087344	97.69	7208512	10651	0.15	96164	70216
11c_12	11c	39793	0	651	0	38748	97.37	39142	19571	19571	37136	94.88	37978	119	0.30	814	443
11c_13	11c	132827	0	1005	0	127447	95.95	131822	65911	65911	123604	93.77	125922	520	0.39	1980	1591
11c_14	11c	2503676	0	28160	0	2487459	99.35	2475516	1237758	1237758	2419436	97.73	2455198	4101	0.17	33192	27527
11c_16	11c	12114924	0	131318	0	12067352	99.61	11983606	5991803	5991803	11727560	97.86	11921672	14362	0.12	178062	129211
11c_17	11c	929147	0	7401	0	923246	99.36	921746	460873	460873	905064	98.19	914090	1755	0.19	6874	4819
11c_20	11c	311495	0	3291	0	306567	98.42	308204	154102	154102	299492	97.17	302982	294	0.10	3390	2161
11c_21	11c	991383	0	10503	0	988525	99.71	980880	490440	490440	961876	98.06	976314	1708	0.17	12750	10448
11c_22	11c	4445564	0	46118	0	4419058	99.40	4399446	2199723	2199723	4310384	97.98	4367522	5418	0.12	48074	34810
11c_23	11c	700436	0	7836	0	695649	99.32	692600	346300	346300	674838	97.44	686300	1513	0.22	8602	6613
11c_24	11c	984939	0	9933	0	974309	98.92	975006	487503	487503	946548	97.08	963094	1282	0.13	14004	10767
11c_25	11c	1630982	0	15448	0	1620745	99.37	1615534	807767	807767	1579370	97.76	1602162	3135	0.19	21728	13934
11c_26	11c	1682793	0	15049	0	1664817	98.93	1667744	833872	833872	1629278	97.69	1647310	2458	0.15	13560	9221
11c_27	11c	237993	0	1857	0	224949	94.52	236136	118068	118068	220886	93.54	222834	258	0.11	1888	1341
11c_28	11c	4137817	0	45003	0	4118379	99.53	4092814	2046407	2046407	3998354	97.69	4067908	5468	0.13	61336	42588
11c_29	11c	282703	0	4551	0	280368	99.17	278152	139076	139076	265166	95.33	274352	1465	0.53	8726	7054
11c_30	11c	10705629	0	104695	0	10662788	99.60	10600934	5300467	5300467	10405914	98.16	10538266	19827	0.19	105072	70296
11c_31	11c	896359	0	10307	0	891456	99.45	886052	443026	443026	867390	97.89	879352	1797	0.20	10566	8161
11c_32	11c	3540629	0	32713	0	3527549	99.63	3507916	1753958	1753958	3451264	98.39	3489590	5246	0.15	27144	14723
11c_33	11c	5532689	0	51049	0	5506702	99.53	5481640	2740820	2740820	5392234	98.37	5448572	7081	0.13	48148	33194
11c_34	11c	42936	0	678	0	42668	99.38	42258	21129	21129	39976	94.60	41796	194	0.46	1698	1204
11c_35	11c	412678	0	3114	0	411434	99.70	409564	204782	204782	402770	98.34	407928	392	0.10	4776	3807
11c_36	11c	581778	0	6466	0	580039	99.70	575312	287656	287656	564416	98.11	572546	1027	0.18	7680	5035
11c_37	11c	192217	0	2243	0	191924	99.85	189974	94987	94987	186712	98.28	189404	277	0.15	2598	2126
11c_38	11c	177167	0	2015	0	176248	99.48	175152	87576	87576	170342	97.25	173968	265	0.15	2952	2155
11c_39	11c	876105	0	7457	0	836422	95.47	868648	434324	434324	820670	94.48	827712	1253	0.14	5514	3833
11c_40	11c	985170	0	6516	0	981676	99.65	978654	489327	489327	964388	98.54	973714	1446	0.15	7612	4443
11c_41	11c	183877	0	2241	0	181179	98.53	181636	90818	90818	173580	95.56	177392	1546	0.85	3450	3013
11c_42	11c	487639	0	4265	0	486257	99.72	483374	241687	241687	474744	98.21	480900	1092	0.23	3928	2875
11c_43	11c	52077	0	1069	0	51677	99.23	51008	25504	25504	48284	94.66	50450	158	0.31	1358	927
11c_44	11c	428696	0	3884	0	426728	99.54	424812	212406	212406	417350	98.24	422132	712	0.17	4004	2766
11c_45	11c	2435413	0	25275	0	2427244	99.66	2410138	1205069	1205069	2363192	98.05	2398268	3701	0.15	31408	23928
11c_46	11c	772069	0	6091	0	768760	99.57	765978	382989	382989	754388	98.49	761640	1029	0.13	5524	4533
11c_47	11c	4827494	0	43858	0	4808085	99.60	4783636	2391818	2391818	4712698	98.52	4756104	8123	0.17	39044	23064
11c_48	11c	148490	0	1448	0	147594	99.40	147042	73521	73521	143376	97.51	145686	460	0.31	2074	1678
11c_49	11c	90788	0	706	0	90479	99.66	90082	45041	45041	87220	96.82	89494	279	0.31	2214	1899
11c_50	11c	24838	0	602	0	24796	99.83	24236	12118	12118	23720	97.87	24158	36	0.15	436	356
12a_01	12a	2390613	0	23731	0	2090400	87.44	2366882	1183441	1183441	2034142	85.94	2054076	12593	0.53	15580	8446
12a_02	12a	5372831	0	47603	0	4854546	90.35	5325228	2662614	2662614	4738874	88.99	4787964	18979	0.36	45320	29120
12a_03	12a	5171308	0	58924	0	4819473	93.20	5112384	2556192	2556192	4692390	91.78	4745032	15517	0.30	46944	32572
12a_04	12a	3156718	0	33028	0	2980369	94.41	3123690	1561845	1561845	2917124	93.39	2941446	5895	0.19	20850	12507
12a_05	12a	624593	0	977	0	143480	22.97	623616	311808	311808	125006	20.05	128600	13903	2.23	3496	676
12a_06	12a	179224	0	1484	0	113605	63.39	177740	88870	88870	109318	61.50	110816	1305	0.73	1160	659
12a_07	12a	417080	0	1450	0	183070	43.89	415630	207815	207815	168356	40.51	173480	8140	1.96	4756	1664
12a_08	12a	3424807	0	53633	0	2889021	84.36	3371174	1685587	1685587	2758544	81.83	2813034	22354	0.66	35382	20174
12a_09	12a	747474	0	2856	0	227394	30.42	744618	372309	372309	199688	26.82	206212	18326	2.46	6028	874
12a_10	12a	422500	0	2296	0	218259	51.66	420204	210102	210102	204212	48.60	207520	8443	2.01	2966	984
12a_11	12a	1009509	0	6069	0	518331	51.34	1003440	501720	501720	490550	48.89	498650	13612	1.36	7676	3610
12a_12	12a	1539432	0	11868	0	1157263	75.17	1527564	763782	763782	1113452	72.89	1130530	14865	0.97	14994	7756
12a_13	12a	5722860	0	58824	0	5582948	97.56	5664036	2832018	2832018	5470020	96.57	5516394	7730	0.14	40344	26071
12a_14	12a	1628519	0	19113	0	1528291	93.85	1609406	804703	804703	1492086	92.71	1506622	2556	0.16	12456	6900
12a_15	12a	1024297	0	10519	0	725348	70.81	1013778	506889	506889	695174	68.57	708194	6635	0.65	11362	7616
12a_16	12a	2333735	0	22909	0	1903769	81.58	2310826	1155413	1155413	1841290	79.68	1866296	14564	0.63	22430	12682
12a_17	12a	1110820	0	7998	0	829362	74.66	1102822	551411	551411	809946	73.44	815680	5684	0.52	5454	3204
12a_18	12a	319613	0	1245	0	154929	48.47	318368	159184	159184	147834	46.43	149856	3828	1.20	1948	1156
12a_19	12a	285993	0	1979	0	170629	59.66	284014	142007	142007	159264	56.08	165212	3438	1.21	5286	3849
12a_20	12a	1055959	0	10067	0	959930	90.91	1045892	522946	522946	939362	89.81	947276	2587	0.25	6334	3758
12a_21	12a	1760274	0	11630	0	1118022	63.51	1748644	874322	874322	1071890	61.30	1085470	20922	1.20	11498	4747
12a_23	12a	1416083	0	10191	0	1006970	71.11	1405892	702946	702946	975328	69.37	985582	11197	0.80	9634	4503
12a_24	12a	996115	0	6627	0	481024	48.29	989488	494744	494744	442160	44.69	454528	19869	2.01	11432	5270
12a_26	12a	3669736	0	35776	0	3237476	88.22	3633960	1816980	1816980	3158842	86.93	3186400	15300	0.42	25092	17422
12a_27	12a	1101561	0	5055	0	578006	52.47	1096506	548253	548253	548170	49.99	558576	14375	1.31	9156	3307
12a_28	12a	2101547	0	20169	0	1742121	82.90	2081378	1040689	1040689	1686784	81.04	1706322	15630	0.75	17578	9701
12a_29	12a	1666753	0	10465	0	1171737	70.30	1656288	828144	828144	1131728	68.33	1145082	16190	0.98	12342	5177
12a_30	12a	184340	0	758	0	75801	41.12	183582	91791	91791	69850	38.05	71878	3165	1.72	1628	472
12a_31	12a	675164	0	2920	0	526986	78.05	672244	336122	336122	514718	76.57	519306	4760	0.71	3958	1755
12a_32	12a	200336	0	872	0	104825	52.32	199464	99732	99732	99552	49.91	101680	2273	1.14	1566	635
12a_33	12a	599056	0	6070	0	542009	90.48	592986	296493	296493	528218	89.08	533536	2403	0.41	4420	2867
12a_34	12a	377909	0	1453	0	121573	32.17	376456	188228	188228	105546	28.04	109868	10252	2.72	3818	1725
12a_35	12a	991002	0	6442	0	750016	75.68	984560	492280	492280	730386	74.18	737844	5730	0.58	6360	3710
12a_37	12a	214225	0	2039	0	140899	65.77	212186	106093	106093	134712	63.49	136432	2428	1.14	1418	749
12a_38	12a	207549	0	1823	0	186785	90.00	205726	102863	102863	181402	88.18	183974	988	0.48	2152	1823
12a_39	12a	798052	0	6242	0	703997	88.21	791810	395905	395905	689872	87.13	695326	2429	0.31	4226	2237
12a_40	12a	205816	0	1906	0	163666	79.52	203910	101955	101955	158628	77.79	160652	1108	0.54	1634	1080
12a_41	12a	26198	0	52	0	12435	47.47	26146	13073	13073	12000	45.90	12248	135	0.52	218	202
12a_42	12a	140333	0	1167	0	101082	72.03	139166	69583	69583	96862	69.60	98664	1251	0.90	1738	1280
12a_43	12a	128863	0	495	0	24879	19.31	128368	64184	64184	20828	16.23	21894	2490	1.94	1036	242
12a_44	12a	1828690	0	18920	0	1779443	97.31	1809770	904885	904885	1738794	96.08	1757324	3199	0.18	16996	11249
12a_45	12a	101052	0	624	0	50064	49.54	100428	50214	50214	46754	46.55	48336	1104	1.10	1500	1000
12a_46	12a	64741	0	353	0	60253	93.07	64388	32194	32194	57446	89.22	59012	888	1.38	1236	1024
12a_48	12a	13690	0	104	0	10240	74.80	13586	6793	6793	9252	68.10	9746	390	2.87	464	403
12a_49	12a	8996334	0	73514	0	8931508	99.28	8922820	4461410	4461410	8810756	98.74	8851106	6888	0.08	34626	19790
12a_50	12a	525786	0	3554	0	344090	65.44	522232	261116	261116	331290	63.44	336414	4122	0.79	4592	1956
12m_01	12m	1331456	0	36080	0	1324899	99.51	1295376	647688	647688	1240932	95.80	1287646	1173	0.09	42380	36475
12m_02	12m	896791	0	22241	0	892810	99.56	874550	437275	437275	844990	96.62	869704	865	0.10	22332	18770
12m_03	12m	35930	0	1290	0	34915	97.18	34640	17320	17320	28758	83.02	32774	851	2.46	3716	3308
12m_04	12m	6948541	0	165023	0	6921524	99.61	6783518	3391759	3391759	6585140	97.08	6751512	4989	0.07	153518	123095
12m_05	12m	3795163	0	99327	0	3784188	99.71	3695836	1847918	1847918	3553130	96.14	3682004	2857	0.08	112844	99374
12m_07	12m	1803336	0	36854	0	1794780	99.53	1766482	883241	883241	1719792	97.36	1756316	1610	0.09	32908	26959
12m_08	12m	491470	0	9744	0	489697	99.64	481726	240863	240863	467112	96.97	479408	545	0.11	11350	9308
12m_09	12m	2253240	0	43184	0	2244079	99.59	2210056	1105028	1105028	2153210	97.43	2199358	1537	0.07	42576	34085
12m_10	12m	32572	0	926	0	32442	99.60	31646	15823	15823	29868	94.38	31394	122	0.39	1480	1310
12m_11	12m	41288	0	1358	0	40600	98.33	39930	19965	19965	36674	91.85	38992	250	0.63	2210	1922
12m_12	12m	336569	0	8861	0	334687	99.44	327708	163854	163854	314722	96.04	325212	614	0.19	9808	8327
12m_13	12m	1879636	0	37114	0	1869810	99.48	1842522	921261	921261	1795248	97.43	1831456	1240	0.07	32790	26423
12m_14	12m	80042	0	2470	0	79770	99.66	77572	38786	38786	74422	95.94	77212	88	0.11	2752	2519
12m_15	12m	72144	0	2014	0	71740	99.44	70130	35065	35065	66764	95.20	69614	112	0.16	2686	2377
12m_16	12m	66059	0	2169	0	65574	99.27	63890	31945	31945	59792	93.59	63192	213	0.33	3266	2889
12m_17	12m	1596283	0	32241	0	1587617	99.46	1564042	782021	782021	1512828	96.73	1553684	1692	0.11	37364	31367
12m_18	12m	9690599	0	191099	0	9647496	99.56	9499500	4749750	4749750	9222320	97.08	9446418	9979	0.11	196792	165712
12m_19	12m	2188082	0	55884	0	2181445	99.70	2132198	1066099	1066099	2064692	96.83	2123920	1641	0.08	52564	45323
12m_20	12m	127635	0	2675	0	127102	99.58	124960	62480	62480	121338	97.10	124288	139	0.11	2752	2122
12m_21	12m	1930543	0	54903	0	1924873	99.71	1875640	937820	937820	1802252	96.09	1868228	1742	0.09	59466	51550
12m_22	12m	554615	0	12387	0	552376	99.60	542228	271114	271114	524912	96.81	539514	475	0.09	13236	11307
12m_23	12m	95453	0	2591	0	95004	99.53	92862	46431	46431	88532	95.34	92134	279	0.30	3394	2927
12m_24	12m	59161	0	1945	0	57511	97.21	57216	28608	28608	47822	83.58	54250	1316	2.30	6144	5644
12m_25	12m	4554579	0	99709	0	4534342	99.56	4454870	2227435	2227435	4304536	96.63	4430494	4139	0.09	116412	99235
12m_26	12m	2473614	0	56214	0	2462195	99.54	2417400	1208700	1208700	2340368	96.81	2403702	2279	0.09	57552	48374
12m_27	12m	2714021	0	63451	0	2703619	99.62	2650570	1325285	1325285	2556760	96.46	2637298	2870	0.11	73380	61372
12m_28	12m	114462	0	3228	0	113404	99.08	111234	55617	55617	104352	93.81	109528	648	0.58	4812	4245
12m_29	12m	2391473	0	58433	0	2385251	99.74	2333040	1166520	1166520	2250684	96.47	2324904	1914	0.08	66506	57682
12m_31	12m	829935	0	22881	0	825801	99.50	807054	403527	403527	772756	95.75	801856	1064	0.13	26452	22076
12m_32	12m	910268	0	21716	0	905380	99.46	888552	444276	444276	856434	96.39	882486	1178	0.13	24072	20877
12m_33	12m	2568487	0	41259	0	2554338	99.45	2527228	1263614	1263614	2460542	97.36	2510872	2207	0.09	45328	35082
12m_34	12m	36114	0	688	0	36000	99.68	35426	17713	17713	33932	95.78	35222	90	0.25	1130	1023
12m_35	12m	451639	0	10627	0	450014	99.64	441012	220506	220506	426718	96.76	438962	425	0.10	10722	8865
12m_36	12m	1183913	0	25659	0	1178854	99.57	1158254	579127	579127	1119876	96.69	1151916	1279	0.11	28958	23631
12m_37	12m	151503	0	2459	0	150436	99.30	149044	74522	74522	144544	96.98	147808	169	0.11	3026	2345
12m_38	12m	87448	0	2098	0	86961	99.44	85350	42675	42675	81448	95.43	84724	139	0.16	3030	2723
12m_39	12m	1286902	0	28260	0	1283323	99.72	1258642	629321	629321	1221050	97.01	1253676	1387	0.11	29466	23588
12m_40	12m	386384	0	8170	0	384820	99.60	378214	189107	189107	365258	96.57	376258	392	0.10	9572	8334
12m_41	12m	73095	0	1925	0	72722	99.49	71170	35585	35585	67608	95.00	70612	185	0.26	2880	2541
12m_42	12m	780776	0	9876	0	776805	99.49	770900	385450	385450	756044	98.07	766096	833	0.11	9054	6513
12m_43	12m	545096	0	9212	0	542909	99.60	535884	267942	267942	522540	97.51	533262	435	0.08	9538	7699
12m_44	12m	274016	0	6238	0	273275	99.73	267778	133889	133889	257494	96.16	266796	241	0.09	8620	7320
12m_45	12m	478379	0	10525	0	477388	99.79	467854	233927	233927	452350	96.69	466562	301	0.06	12672	10201
12m_46	12m	190540	0	4704	0	189867	99.65	185836	92918	92918	179806	96.76	185032	131	0.07	4548	3618
12m_47	12m	7820356	0	168938	0	7786103	99.56	7651418	3825709	3825709	7399820	96.71	7610150	7015	0.09	187882	165712
12m_48	12m	212332	0	3950	0	211165	99.45	208382	104191	104191	200778	96.35	206726	489	0.23	5456	4641
12m_49	12m	286074	0	5962	0	284617	99.49	280112	140056	140056	268966	96.02	277886	769	0.27	7754	6496
12m_50	12m	50094	0	962	0	49436	98.69	49132	24566	24566	46936	95.53	48148	326	0.66	1154	978
14a_04	14a	629595	0	6917	0	628091	99.76	622678	311339	311339	612854	98.42	620236	938	0.15	6884	5288
14a_06	14a	1325521	0	13521	0	1322868	99.80	1312000	656000	656000	1293850	98.62	1308012	1335	0.10	13054	9305
14a_08	14a	2255810	0	22856	0	2251384	99.80	2232954	1116477	1116477	2204380	98.72	2226396	2132	0.10	19188	15429
14a_10	14a	1995846	0	24864	0	1991223	99.77	1970982	985491	985491	1938812	98.37	1964534	1825	0.09	22904	17510
14a_11	14a	2899164	0	33470	0	2894125	99.83	2865694	1432847	1432847	2827032	98.65	2858406	2249	0.08	24954	17838
14a_13	14a	4741863	0	45179	0	4730631	99.76	4696684	2348342	2348342	4643430	98.87	4680980	4472	0.10	31962	23167
14a_16	14a	1686338	0	29206	0	1682324	99.76	1657132	828566	828566	1616582	97.55	1651178	1940	0.12	28882	23196
14a_18	14a	1435039	0	14323	0	1431398	99.75	1420716	710358	710358	1402532	98.72	1415320	1755	0.12	11092	8539
14a_19	14a	818189	0	11625	0	816065	99.74	806564	403282	403282	789880	97.93	803146	1294	0.16	11686	9630
14a_20	14a	5217612	0	70792	0	5208764	99.83	5146820	2573410	2573410	5069822	98.50	5134524	3448	0.07	57302	43106
14a_22	14a	4264610	0	61512	0	4257055	99.82	4203098	2101549	2101549	4134972	98.38	4192272	3271	0.08	51022	40212
14a_23	14a	3469910	0	58862	0	3462176	99.78	3411048	1705524	1705524	3345034	98.06	3399966	3348	0.10	47656	36956
14a_24	14a	1508966	0	30746	0	1504128	99.68	1478220	739110	739110	1441300	97.50	1471868	1514	0.10	26854	22486
14a_25	14a	2111830	0	23018	0	2108197	99.83	2088812	1044406	1044406	2061886	98.71	2083376	1803	0.09	18672	14359
14a_26	14a	1371811	0	14237	0	1369594	99.84	1357574	678787	678787	1339874	98.70	1354152	1205	0.09	11222	8414
14a_27	14a	733019	0	6209	0	731479	99.79	726810	363405	363405	718692	98.88	724364	906	0.12	4902	3192
14a_28	14a	725454	0	6084	0	723581	99.74	719370	359685	359685	712074	98.99	716838	659	0.09	4450	2700
14a_30	14a	2857794	0	32580	0	2853414	99.85	2825214	1412607	1412607	2789372	98.73	2818536	2298	0.08	24182	16770
14a_31	14a	1010808	0	11482	0	1009288	99.85	999326	499663	499663	985372	98.60	997014	792	0.08	9834	7442
14a_37	14a	6804305	0	91153	0	6789041	99.78	6713152	3356576	3356576	6603242	98.36	6691656	6232	0.09	75696	60321
14a_38	14a	379145	0	4957	0	377711	99.62	374188	187094	187094	363670	97.19	371634	1120	0.30	7552	6251
14a_40	14a	2269167	0	22863	0	2264401	99.79	2246304	1123152	1123152	2221320	98.89	2240084	1454	0.06	16686	12403
14a_43	14a	284156	0	3172	0	282932	99.57	280984	140492	140492	275122	97.91	279004	756	0.27	3664	3073
14a_44	14a	1463718	0	14642	0	1460935	99.81	1449076	724538	724538	1432318	98.84	1444812	1481	0.10	11480	8784
14a_45	14a	2225418	0	29120	0	2221372	99.82	2196298	1098149	1098149	2166276	98.63	2190400	1852	0.08	21354	15544
14a_47	14a	753315	0	7217	0	751462	99.75	746098	373049	373049	737076	98.79	743438	807	0.11	5508	3897
14a_48	14a	2206603	0	31041	0	2202298	99.80	2175562	1087781	1087781	2143660	98.53	2169458	1799	0.08	21078	14937
14a_49	14a	1922931	0	23769	0	1918799	99.79	1899162	949581	949581	1872086	98.57	1893580	1450	0.08	18534	13794
14a_50	14a	2813091	0	36727	0	2806087	99.75	2776364	1388182	1388182	2735918	98.54	2766516	2844	0.10	27622	21616
17a_01	17a	808579	0	8381	0	802601	99.26	800198	400099	400099	780662	97.56	792864	1356	0.17	10334	8422
17a_02	17a	1097128	0	11416	0	1091973	99.53	1085712	542856	542856	1058566	97.50	1077802	2755	0.25	15908	13759
17a_03	17a	8948268	0	89920	0	8921013	99.70	8858348	4429174	4429174	8700742	98.22	8818746	12347	0.14	106152	77520
17a_04	17a	2023388	0	18708	0	2005183	99.10	2004680	1002340	1002340	1964066	97.97	1982486	3989	0.20	15536	9703
17a_05	17a	599223	0	5799	0	595720	99.42	593424	296712	296712	583306	98.29	589280	641	0.11	5638	4455
17a_06	17a	4902672	0	42384	0	4887711	99.69	4860288	2430144	2430144	4787072	98.49	4839452	5875	0.12	43546	31384
17a_07	17a	41902	0	414	0	41748	99.63	41488	20744	20744	40234	96.98	41210	124	0.30	896	777
17a_08	17a	324943	0	3061	0	321876	99.06	321882	160941	160941	312968	97.23	317888	927	0.29	3118	2541
17a_09	17a	40756	0	630	0	40592	99.60	40126	20063	20063	38828	96.77	39806	156	0.39	942	814
17a_10	17a	2557862	0	19204	0	2547449	99.59	2538658	1269329	1269329	2502412	98.57	2525350	2895	0.11	17720	12265
17a_11	17a	113261	0	915	0	112965	99.74	112346	56173	56173	109574	97.53	111766	284	0.25	1584	1399
17a_12	17a	649658	0	8124	0	636333	97.95	641534	320767	320767	613354	95.61	627052	1157	0.18	11990	10947
17a_13	17a	1488868	0	18960	0	1475326	99.09	1469908	734954	734954	1425242	96.96	1453688	2678	0.18	24234	20731
17a_14	17a	8963437	0	81701	0	8939141	99.73	8881736	4440868	4440868	8759696	98.63	8846414	11026	0.12	70344	50667
17a_15	17a	900941	0	10685	0	898140	99.69	890256	445128	445128	869518	97.67	886152	1303	0.15	15634	13692
17a_16	17a	3710553	0	35349	0	3689801	99.44	3675204	1837602	1837602	3609402	98.21	3649154	5298	0.14	34884	26552
17a_17	17a	737202	0	6868	0	732289	99.33	730334	365167	365167	711570	97.43	724554	867	0.12	9430	6738
17a_18	17a	2868925	0	24409	0	2862853	99.79	2844516	1422258	1422258	2807868	98.71	2835790	2654	0.09	23370	18138
17a_19	17a	112841	0	1611	0	112202	99.43	111230	55615	55615	107048	96.24	110262	329	0.30	2028	1473
17a_20	17a	1951405	0	20703	0	1944673	99.66	1930702	965351	965351	1897054	98.26	1921812	2158	0.11	22332	18286
17a_21	17a	2143674	0	31772	0	2139126	99.79	2111902	1055951	1055951	2050334	97.08	2103838	3516	0.17	48940	39417
17a_22	17a	3428690	0	35616	0	3418609	99.71	3393074	1696537	1696537	3324624	97.98	3378690	4303	0.13	49684	31979
17a_23	17a	11681	0	169	0	11588	99.20	11512	5756	5756	10788	93.71	11328	91	0.79	494	449
17a_24	17a	129498	0	1300	0	112561	86.92	128198	64099	64099	110240	85.99	111126	135	0.11	804	521
17a_25	17a	846191	0	8783	0	843074	99.63	837408	418704	418704	822494	98.22	832502	1789	0.21	8868	6429
17a_26	17a	15370885	0	172021	0	15286806	99.45	15198864	7599432	7599432	14871762	97.85	15090032	24753	0.16	198842	149169
17a_27	17a	8802110	0	83302	0	8780752	99.76	8718808	4359404	4359404	8605422	98.70	8687146	10304	0.12	70628	47917
17a_28	17a	6799121	0	60269	0	6771699	99.60	6738852	3369426	3369426	6640276	98.54	6701788	9642	0.14	48156	35043
17a_29	17a	6400309	0	55283	0	6380559	99.69	6345026	3172513	3172513	6260430	98.67	6318084	7192	0.11	50144	40189
17a_30	17a	1450017	0	19123	0	1446065	99.73	1430894	715447	715447	1387216	96.95	1424710	2232	0.16	33180	27900
17a_31	17a	3964356	0	47174	0	3953381	99.72	3917182	1958591	1958591	3844574	98.15	3901382	4825	0.12	50666	38834
17a_32	17a	8329831	0	84839	0	8310427	99.77	8244992	4122496	4122496	8093972	98.17	8213324	12264	0.15	106662	74445
17a_33	17a	1016001	0	8651	0	1008337	99.25	1007350	503675	503675	990744	98.35	998390	1296	0.13	6622	4739
17a_34	17a	806138	0	9562	0	802348	99.53	796576	398288	398288	780516	97.98	791376	1410	0.18	9812	7036
17a_35	17a	3503781	0	33859	0	3495167	99.75	3469922	1734961	1734961	3425256	98.71	3456632	4676	0.13	24794	15540
17a_36	17a	4052312	0	48106	0	4042266	99.75	4004206	2002103	2002103	3927882	98.09	3988578	5582	0.14	54104	41405
17a_37	17a	1584040	0	18870	0	1577776	99.60	1565170	782585	782585	1525170	97.44	1556556	2350	0.15	28946	23492
17a_38	17a	2016088	0	25672	0	2006757	99.54	1990416	995208	995208	1943800	97.66	1977306	3779	0.19	29668	23271
17a_39	17a	4673258	0	56044	0	4659292	99.70	4617214	2308607	2308607	4512864	97.74	4596202	7046	0.15	72502	58022
17a_40	17a	1610667	0	16401	0	1602434	99.49	1594266	797133	797133	1556616	97.64	1583406	2627	0.16	22710	18762
17a_41	17a	2089635	0	19157	0	2086216	99.84	2070478	1035239	1035239	2042522	98.65	2064504	2555	0.12	18920	13914
17a_42	17a	818247	0	7477	0	815700	99.69	810770	405385	405385	799222	98.58	807436	787	0.10	7278	3614
17a_43	17a	691169	0	8087	0	688567	99.62	683082	341541	341541	667842	97.77	679676	804	0.12	10788	8931
17a_44	17a	363143	0	4721	0	360125	99.17	358422	179211	179211	348112	97.12	354888	516	0.14	5608	4711
17a_45	17a	8210580	0	92854	0	8185353	99.69	8117726	4058863	4058863	7967570	98.15	8083036	9463	0.12	102790	78818
17a_46	17a	1114475	0	12849	0	1111365	99.72	1101626	550813	550813	1083264	98.33	1097514	1002	0.09	11066	8342
17a_47	17a	8895484	0	99182	0	8873268	99.75	8796302	4398151	4398151	8644720	98.28	8763918	10168	0.12	97402	69215
17a_48	17a	351909	0	3491	0	351200	99.80	348418	174209	174209	341776	98.09	347256	453	0.13	5212	4095
17a_49	17a	303351	0	2855	0	301971	99.55	300496	150248	150248	294856	98.12	298482	634	0.21	3434	2607
17a_50	17a	5216128	0	48412	0	5203060	99.75	5167716	2583858	2583858	5089400	98.48	5148388	6260	0.12	48474	33022
17b_01	17b	3178977	0	28861	0	3165656	99.58	3150116	1575058	1575058	3098268	98.35	3131156	5639	0.18	27714	17598
17b_02	17b	17196555	0	143023	0	17133218	99.63	17053532	8526766	8526766	16795884	98.49	16960900	29295	0.17	137060	92632
17b_03	17b	2799862	0	31062	0	2791728	99.71	2768800	1384400	1384400	2718164	98.17	2756008	4658	0.17	30858	22551
17b_04	17b	7662371	0	86957	0	7640762	99.72	7575414	3787707	3787707	7430708	98.09	7542112	11693	0.15	102346	75618
17b_05	17b	2937041	0	25469	0	2925926	99.62	2911572	1455786	1455786	2873724	98.70	2895532	4925	0.17	19306	11241
17b_06	17b	6679690	0	63426	0	6653950	99.61	6616264	3308132	3308132	6510454	98.40	6582406	8118	0.12	59124	38147
17b_07	17b	3030544	0	28502	0	3023881	99.78	3002042	1501021	1501021	2942376	98.01	2991656	3723	0.12	41970	29401
17b_08	17b	8549198	0	88898	0	8528794	99.76	8460300	4230150	4230150	8336888	98.54	8430042	9854	0.12	81880	64026
17b_09	17b	3151719	0	31641	0	3133815	99.43	3120078	1560039	1560039	3061366	98.12	3097150	5024	0.16	31888	20529
17b_10	17b	8576823	0	89709	0	8557437	99.77	8487114	4243557	4243557	8355884	98.45	8456504	11224	0.13	87030	65262
17b_11	17b	5010782	0	51948	0	4986971	99.52	4958834	2479417	2479417	4856266	97.93	4928446	6577	0.13	61320	47590
17b_12	17b	615279	0	5139	0	612831	99.60	610140	305070	305070	600390	98.40	606466	1226	0.20	5320	3193
17b_13	17b	307899	0	2407	0	306854	99.66	305492	152746	152746	300864	98.49	303892	555	0.18	2952	2243
17b_14	17b	4850331	0	46303	0	4835845	99.70	4804028	2402014	2402014	4736760	98.60	4784260	5282	0.11	42034	26616
17b_15	17b	277360	0	4618	0	276915	99.84	272742	136371	136371	267528	98.09	271914	383	0.14	3374	1881
17b_16	17b	465172	0	4152	0	463811	99.71	461020	230510	230510	453764	98.43	459276	383	0.08	5378	3352
17b_17	17b	1141394	0	12098	0	1135480	99.48	1129296	564648	564648	1107872	98.10	1121382	2000	0.18	11602	7084
17b_18	17b	1007086	0	7728	0	1004557	99.75	999358	499679	499679	983960	98.46	994776	2053	0.21	9210	6464
17b_19	17b	898357	0	7569	0	895113	99.64	890788	445394	445394	876500	98.40	886192	1352	0.15	8248	5155
17b_20	17b	1904230	0	18124	0	1891517	99.33	1886106	943053	943053	1853114	98.25	1870390	3003	0.16	16114	12410
17b_21	17b	224806	0	2130	0	218974	97.41	222676	111338	111338	213164	95.73	215888	956	0.43	2292	1679
17b_22	17b	149215	0	1557	0	147594	98.91	147658	73829	73829	143952	97.49	145876	161	0.11	1758	994
17b_23	17b	1802743	0	14525	0	1796561	99.66	1788218	894109	894109	1767024	98.81	1779866	2170	0.12	10240	6257
17b_24	17b	2414483	0	23327	0	2403635	99.55	2391156	1195578	1195578	2354444	98.46	2376374	3934	0.16	19358	12678
17b_25	17b	2041265	0	16733	0	2032890	99.59	2024532	1012266	1012266	1993554	98.47	2013632	2525	0.12	15384	10550
17b_26	17b	2066026	0	19528	0	2057051	99.57	2046498	1023249	1023249	2009670	98.20	2033428	4095	0.20	18514	11258
17b_27	17b	1351246	0	13286	0	1346871	99.68	1337960	668980	668980	1315594	98.33	1331754	1831	0.14	12660	10590
17b_28	17b	26495	0	319	0	25628	96.73	26176	13088	13088	23170	88.52	24854	455	1.74	1598	1437
17b_29	17b	820660	0	8982	0	819317	99.84	811678	405839	405839	798374	98.36	809108	1227	0.15	10258	4341
17b_30	17b	52062	0	288	0	51461	98.85	51774	25887	25887	50038	96.65	50980	193	0.37	854	693
17b_31	17b	1034309	0	11833	0	1031306	99.71	1022476	511238	511238	1004978	98.29	1018368	1105	0.11	11488	9237
17b_32	17b	5348997	0	47551	0	5330566	99.66	5301446	2650723	2650723	5237964	98.80	5275502	7513	0.14	32592	16636
17b_33	17b	1098659	0	12033	0	1093903	99.57	1086626	543313	543313	1065652	98.07	1079476	2394	0.22	11894	6578
17b_34	17b	1353080	0	14136	0	1345159	99.41	1338944	669472	669472	1308106	97.70	1327570	3453	0.26	17780	11696
17b_35	17b	510081	0	4661	0	507011	99.40	505420	252710	252710	497584	98.45	501620	730	0.14	3860	2489
17b_36	17b	36379	0	667	0	35530	97.67	35712	17856	17856	33526	93.88	34702	161	0.45	1118	877
17b_37	17b	11261806	0	101608	0	11228454	99.70	11160198	5580099	5580099	11001296	98.58	11110318	16528	0.15	98526	71168
17b_38	17b	1034394	0	9042	0	1031694	99.74	1025352	512676	512676	1009960	98.50	1020552	2100	0.20	8778	5500
17b_39	17b	533295	0	4563	0	531374	99.64	528732	264366	264366	518818	98.12	525630	1181	0.22	5562	3072
17b_40	17b	1063059	0	12323	0	1059552	99.67	1050736	525368	525368	1034700	98.47	1045456	1773	0.17	7814	4756
17b_41	17b	2863289	0	28563	0	2854344	99.69	2834726	1417363	1417363	2794190	98.57	2821740	4041	0.14	22108	10705
17b_42	17b	1297759	0	11777	0	1293434	99.67	1285982	642991	642991	1268244	98.62	1279858	1799	0.14	10076	7057
17b_43	17b	7381945	0	72681	0	7350347	99.57	7309264	3654632	3654632	7183504	98.28	7265552	12114	0.17	68370	44630
17b_44	17b	4262059	0	39363	0	4240431	99.49	4222696	2111348	2111348	4154622	98.39	4191026	10042	0.24	30812	23683
17b_45	17b	402160	0	4264	0	400011	99.47	397896	198948	198948	390076	98.03	394958	789	0.20	3722	2697
17b_46	17b	379820	0	3724	0	378065	99.54	376096	188048	188048	371474	98.77	373806	535	0.14	1514	939
17b_47	17b	656199	0	5763	0	654735	99.78	650436	325218	325218	640296	98.44	647622	1350	0.21	6328	4550
17b_48	17b	87497	0	703	0	87350	99.83	86794	43397	43397	84424	97.27	86508	139	0.16	2070	1788
17b_49	17b	698786	0	11316	0	695532	99.53	687470	343735	343735	669994	97.46	683244	972	0.14	12180	8569
17b_50	17b	1592653	0	16667	0	1585131	99.53	1575986	787993	787993	1549968	98.35	1565506	2958	0.19	13130	8648
17c_01	17c	79635	0	909	0	64349	80.80	78726	39363	39363	61758	78.45	63180	260	0.33	1376	852
17c_02	17c	175544	0	1432	0	160538	91.45	174112	87056	87056	155552	89.34	158122	984	0.57	2410	1138
17c_03	17c	212001	0	1951	0	182164	85.93	210050	105025	105025	175758	83.67	177750	2463	1.17	1890	999
17c_04	17c	126930	0	1642	0	97443	76.77	125288	62644	62644	89132	71.14	93540	2261	1.80	4076	2541
17c_05	17c	109221	0	753	0	75864	69.46	108468	54234	54234	70190	64.71	73038	2073	1.91	2714	2105
17c_06	17c	985047	0	9987	0	955920	97.04	975060	487530	487530	934868	95.88	943570	2363	0.24	7582	4303
17c_07	17c	385632	0	3370	0	352524	91.41	382262	191131	191131	344782	90.20	348344	810	0.21	3182	1729
17c_08	17c	78002	0	662	0	69168	88.67	77340	38670	38670	67256	86.96	67882	624	0.81	606	339
17c_09	17c	249820	0	1708	0	237405	95.03	248112	124056	124056	233608	94.15	235172	525	0.21	1118	749
17c_10	17c	141197	0	1469	0	122323	86.63	139728	69864	69864	117904	84.38	119608	1246	0.89	1624	1126
17c_11	17c	657471	0	5219	0	627096	95.38	652252	326126	326126	616618	94.54	620530	1347	0.21	3066	2046
17c_12	17c	984673	0	9387	0	966748	98.18	975286	487643	487643	948186	97.22	956084	1277	0.13	6698	4762
17c_13	17c	558059	0	4313	0	493953	88.51	553746	276873	276873	482360	87.11	487582	2058	0.37	4420	2898
17c_14	17c	2195218	0	21490	0	2132732	97.15	2173728	1086864	1086864	2087944	96.05	2108242	3000	0.14	18070	10646
17c_15	17c	312771	0	2151	0	237079	75.80	310620	155310	155310	230200	74.11	231926	3002	0.97	1640	1129
17c_16	17c	411729	0	4501	0	371505	90.23	407228	203614	203614	362180	88.94	365752	1252	0.31	3302	2326
17c_17	17c	742495	0	8699	0	724982	97.64	733796	366898	366898	707824	96.46	715166	1117	0.15	5152	3604
17c_18	17c	825140	0	7208	0	806672	97.76	817932	408966	408966	788586	96.41	798562	902	0.11	7926	5357
17c_19	17c	171300	0	982	0	81881	47.80	170318	85159	85159	76352	44.83	77698	3201	1.88	1286	237
17c_20	17c	1584945	0	22027	0	1536874	96.97	1562918	781459	781459	1493306	95.55	1513204	1643	0.11	18112	14371
17c_21	17c	2650192	0	39064	0	2504852	94.52	2611128	1305564	1305564	2429528	93.05	2459922	5866	0.22	26404	17816
17c_22	17c	1789119	0	21663	0	1648480	92.14	1767456	883728	883728	1600376	90.55	1620286	6531	0.37	16658	10786
17c_23	17c	916770	0	9314	0	867743	94.65	907456	453728	453728	849004	93.56	856626	1803	0.20	7210	4685
17c_24	17c	1212265	0	11313	0	1188889	98.07	1200952	600476	600476	1165564	97.05	1176302	1274	0.11	9624	6182
17c_25	17c	2415032	0	29382	0	2386860	98.83	2385650	1192825	1192825	2326880	97.54	2355664	1814	0.08	26510	19955
17c_26	17c	3628052	0	37160	0	3578924	98.65	3590892	1795446	1795446	3516414	97.93	3538584	3180	0.09	20018	12715
17c_27	17c	9189603	0	97923	0	9095696	98.98	9091680	4545840	4545840	8901948	97.91	8991474	6299	0.07	77344	56881
17c_28	17c	2373726	0	39128	0	2291296	96.53	2334598	1167299	1167299	2204802	94.44	2247526	4642	0.20	39400	32215
17c_29	17c	4266280	0	53162	0	4121686	96.61	4213118	2106559	2106559	4012418	95.24	4061238	7286	0.17	41774	30302
17c_30	17c	626061	0	3497	0	262838	41.98	622564	311282	311282	238750	38.35	246630	12711	2.04	7020	3690
17c_31	17c	2703661	0	38041	0	2451971	90.69	2665620	1332810	1332810	2368220	88.84	2403202	10728	0.40	30848	21721
17c_32	17c	276452	0	2328	0	257673	93.21	274124	137062	137062	252772	92.21	254570	775	0.28	1714	1455
17c_33	17c	2382815	0	26361	0	2285311	95.91	2356454	1178227	1178227	2228080	94.55	2255034	3916	0.17	22406	16093
17c_34	17c	555002	0	5980	0	538993	97.12	549022	274511	274511	527102	96.01	532378	635	0.12	4844	3374
17c_35	17c	1139843	0	10041	0	1015308	89.07	1129802	564901	564901	989130	87.55	1000950	4317	0.38	10966	8064
17c_36	17c	3749207	0	41995	0	3667834	97.83	3707212	1853606	1853606	3584304	96.68	3621202	4637	0.13	33452	24150
17c_37	17c	4076507	0	35247	0	3996090	98.03	4041260	2020630	2020630	3928116	97.20	3956434	4409	0.11	23410	15303
17c_38	17c	1179590	0	16488	0	1118435	94.82	1163102	581551	581551	1082096	93.04	1098488	3459	0.30	14540	11536
17c_39	17c	6900344	0	80814	0	6816981	98.79	6819530	3409765	3409765	6656442	97.61	6730574	5593	0.08	67746	46079
17c_40	17c	1265918	0	7962	0	1220156	96.39	1257956	628978	628978	1202342	95.58	1210926	1268	0.10	7978	5560
17c_41	17c	456812	0	4214	0	447753	98.02	452598	226299	226299	439814	97.18	443098	441	0.10	3022	2086
17c_42	17c	639315	0	6757	0	603230	94.36	632558	316279	316279	589240	93.15	595286	1187	0.19	4666	2704
17c_43	17c	2075919	0	26109	0	2034516	98.01	2049810	1024905	1024905	1986930	96.93	2006660	1747	0.09	17690	11822
17c_44	17c	3264930	0	33978	0	3161156	96.82	3230952	1615476	1615476	3092796	95.72	3122470	4708	0.15	26968	18500
17c_45	17c	1403723	0	14039	0	1294743	92.24	1389684	694842	694842	1262270	90.83	1275804	4900	0.35	12596	8626
17c_46	17c	886732	0	6584	0	774953	87.39	880148	440074	440074	756902	86.00	765706	2663	0.30	6504	3495
17c_47	17c	593927	0	4809	0	515344	86.77	589118	294559	294559	501254	85.09	507180	3355	0.57	5758	3301
17c_48	17c	948567	0	11039	0	919304	96.92	937528	468764	468764	895606	95.53	906522	1743	0.19	9346	7578
17c_49	17c	658438	0	5704	0	561381	85.26	652734	326367	326367	547376	83.86	552928	2749	0.42	5320	4050
17c_50	17c	5981475	0	53223	0	5913421	98.86	5928252	2964126	2964126	5806560	97.95	5854996	5202	0.09	40584	28382
18a_01	18a	252916	0	2172	0	250148	98.91	250744	125372	125372	243068	96.94	247470	506	0.20	4326	2581
18a_02	18a	42179	0	949	0	40547	96.13	41230	20615	20615	35192	85.36	39040	558	1.35	3268	3004
18a_03	18a	498785	0	6193	0	496420	99.53	492592	246296	246296	483172	98.09	489400	827	0.17	6078	4027
18a_04	18a	78919	0	1263	0	77728	98.49	77656	38828	38828	71890	92.57	75678	787	1.01	3636	3288
18a_05	18a	9529	0	347	0	9218	96.74	9182	4591	4591	7306	79.57	8578	293	3.19	1242	1135
18a_06	18a	1352564	0	9624	0	1347084	99.59	1342940	671470	671470	1319130	98.23	1336038	1422	0.11	14530	8684
18a_07	18a	75322	0	536	0	74317	98.67	74786	37393	37393	72108	96.42	73446	335	0.45	1264	995
18a_08	18a	37615	0	411	0	31279	83.16	37204	18602	18602	29478	79.23	30660	208	0.56	1134	953
18a_09	18a	208459	0	1665	0	191128	91.69	206794	103397	103397	185818	89.86	188802	661	0.32	2612	2193
18a_10	18a	140256	0	1566	0	137723	98.19	138690	69345	69345	131202	94.60	135324	833	0.60	3724	3371
18a_11	18a	171052	0	2016	0	164723	96.30	169036	84518	84518	158824	93.96	162254	453	0.27	2580	2100
18a_12	18a	927567	0	8215	0	915215	98.67	919352	459676	459676	894744	97.32	905072	1928	0.21	9164	5798
18a_13	18a	407390	0	3436	0	395615	97.11	403954	201977	201977	388202	96.10	391666	513	0.13	3028	2194
18a_14	18a	189824	0	1994	0	188756	99.44	187830	93915	93915	182464	97.14	185970	792	0.42	3378	2577
18a_15	18a	71521	0	907	0	70852	99.06	70614	35307	35307	68354	96.80	69720	225	0.32	1330	920
18a_16	18a	1125512	0	8838	0	1120097	99.52	1116674	558337	558337	1098152	98.34	1109328	1931	0.17	10266	7591
18a_17	18a	164382	0	2010	0	163790	99.64	162372	81186	81186	157944	97.27	161536	244	0.15	2298	1739
18a_18	18a	1583298	0	14242	0	1578625	99.70	1569056	784528	784528	1548050	98.66	1562764	1619	0.10	11072	7154
18a_19	18a	12520	0	116	0	12441	99.37	12404	6202	6202	11488	92.62	12246	79	0.64	744	665
18a_21	18a	2026690	0	21450	0	2015207	99.43	2005240	1002620	1002620	1969280	98.21	1990906	2851	0.14	19744	12852
18a_22	18a	6422879	0	51583	0	6391588	99.51	6371296	3185648	3185648	6271282	98.43	6330590	9415	0.15	52550	37255
18a_23	18a	18228064	0	212046	0	18165114	99.65	18016018	9008009	9008009	17618388	97.79	17932468	20600	0.11	269026	184804
18a_24	18a	540211	0	5197	0	536093	99.24	535014	267507	267507	523542	97.86	529968	928	0.17	4266	3330
18a_25	18a	426666	0	3140	0	423848	99.34	423526	211763	211763	416648	98.38	420268	440	0.10	2608	1440
18a_26	18a	2388070	0	21284	0	2371437	99.30	2366786	1183393	1183393	2319412	98.00	2346876	3277	0.14	25450	19897
18a_27	18a	870064	0	7784	0	864224	99.33	862280	431140	431140	842390	97.69	855052	1388	0.16	11492	8353
18a_28	18a	21050769	0	216019	0	20952028	99.53	20834750	10417375	10417375	20396960	97.90	20712348	23661	0.11	251410	195567
18a_29	18a	439866	0	5100	0	437310	99.42	434766	217383	217383	424676	97.68	430844	1366	0.31	5114	3742
18a_30	18a	1633043	0	15801	0	1626562	99.60	1617242	808621	808621	1589844	98.31	1608292	2469	0.15	16880	11008
18a_31	18a	309469	0	3431	0	307652	99.41	306038	153019	153019	295168	96.45	303606	615	0.20	6148	4293
18a_32	18a	50536	0	824	0	36913	73.04	49712	24856	24856	34556	69.51	35914	175	0.35	1306	998
18a_33	18a	70037	0	897	0	61591	87.94	69140	34570	34570	58170	84.13	60144	550	0.80	1870	1596
18a_34	18a	3680712	0	28352	0	3665518	99.59	3652360	1826180	1826180	3605234	98.71	3631916	5250	0.14	22960	15119
18a_35	18a	1237778	0	8668	0	1232619	99.58	1229110	614555	614555	1209900	98.44	1221872	2079	0.17	9244	7290
18a_36	18a	450738	0	4702	0	449127	99.64	446036	223018	223018	441222	98.92	443888	537	0.12	2604	1950
18a_37	18a	2421498	0	22280	0	2406664	99.39	2399218	1199609	1199609	2353432	98.09	2381624	2760	0.12	24806	18012
18a_38	18a	4822196	0	50666	0	4807604	99.70	4771530	2385765	2385765	4698756	98.47	4750348	6590	0.14	43530	29824
18a_39	18a	1995804	0	15784	0	1985067	99.46	1980020	990010	990010	1945956	98.28	1967048	2235	0.11	16838	11922
18a_40	18a	6469487	0	60157	0	6447013	99.65	6409330	3204665	3204665	6307180	98.41	6375980	10876	0.17	55856	34344
18a_42	18a	7143953	0	64041	0	7119396	99.66	7079912	3539956	3539956	6969656	98.44	7044530	10825	0.15	59450	41970
18a_43	18a	493952	0	6162	0	491968	99.60	487790	243895	243895	478140	98.02	485212	594	0.12	5896	3868
18a_44	18a	187537	0	2625	0	186837	99.63	184912	92456	92456	180912	97.84	183982	230	0.12	3048	1671
18a_46	18a	1520981	0	15139	0	1505171	98.96	1505842	752921	752921	1465172	97.30	1487344	2688	0.18	19400	14822
18a_48	18a	918638	0	7094	0	913319	99.42	911544	455772	455772	895488	98.24	904298	1927	0.21	6592	5306
18a_49	18a	2528078	0	20236	0	2518277	99.61	2507842	1253921	1253921	2469036	98.45	2493788	4253	0.17	19710	15032
18a_50	18a	666927	0	8561	0	663815	99.53	658366	329183	329183	637666	96.86	653502	1752	0.27	13282	11702
18b_02	18b	1176250	0	22100	0	1143375	97.21	1154150	577075	577075	1097206	95.07	1119522	1753	0.15	20488	16365
18b_03	18b	1706510	0	24902	0	1683031	98.62	1681608	840804	840804	1631504	97.02	1656312	1817	0.11	22986	17091
18b_04	18b	4050735	0	50699	0	3987302	98.43	4000036	2000018	2000018	3882346	97.06	3931908	4695	0.12	45406	36485
18b_06	18b	7210364	0	101558	0	7073104	98.10	7108806	3554403	3554403	6864490	96.56	6965240	6306	0.09	87474	68734
18b_07	18b	5691057	0	94181	0	5584339	98.12	5596876	2798438	2798438	5395078	96.39	5485002	5156	0.09	82010	65190
18b_08	18b	7326027	0	102507	0	7222144	98.58	7223520	3611760	3611760	7012504	97.08	7113038	6599	0.09	87332	72185
18b_09	18b	1033871	0	9919	0	1024129	99.06	1023952	511976	511976	1003280	97.98	1013096	1114	0.11	8928	5881
18b_10	18b	7175174	0	125054	0	7052859	98.30	7050120	3525060	3525060	6787958	96.28	6920642	7163	0.10	116396	99173
18b_11	18b	2334996	0	37502	0	2307915	98.84	2297494	1148747	1148747	2229474	97.04	2268074	2339	0.10	33440	28038
18b_12	18b	1589539	0	21573	0	1574118	99.03	1567966	783983	783983	1532130	97.71	1551122	1423	0.09	17288	13931
18b_13	18b	3882374	0	67126	0	3849442	99.15	3815248	1907624	1907624	3715566	97.39	3778406	3910	0.10	56732	47039
18b_15	18b	5417376	0	65374	0	5360229	98.95	5352002	2676001	2676001	5239792	97.90	5290398	4457	0.08	44700	33480
18b_16	18b	4450630	0	67148	0	4403573	98.94	4383482	2191741	2191741	4269220	97.39	4332274	4151	0.09	56440	45217
18b_17	18b	3358188	0	45832	0	3312651	98.64	3312356	1656178	1656178	3222712	97.29	3264054	2765	0.08	36902	27459
18b_18	18b	2417574	0	48034	0	2388269	98.79	2369540	1184770	1184770	2287790	96.55	2337244	2991	0.13	44602	37740
18b_19	18b	9476967	0	115811	0	9361973	98.79	9361156	4680578	4680578	9133998	97.57	9237736	8426	0.09	93486	73835
18b_20	18b	4718511	0	57815	0	4661001	98.78	4660696	2330348	2330348	4542154	97.46	4598948	4238	0.09	48240	39855
18b_21	18b	5897148	0	83768	0	5832156	98.90	5813380	2906690	2906690	5671792	97.56	5742218	6170	0.11	62162	50300
18b_22	18b	9534498	0	136364	0	9348367	98.05	9398134	4699067	4699067	9074654	96.56	9201378	10625	0.11	108466	85580
18b_23	18b	3903721	0	49913	0	3851833	98.67	3853808	1926904	1926904	3752002	97.36	3798410	3510	0.09	40920	28030
18b_24	18b	4105443	0	48301	0	4059706	98.89	4057142	2028571	2028571	3965520	97.74	4008150	3255	0.08	39274	31566
18b_26	18b	4355865	0	54329	0	4317460	99.12	4301536	2150768	2150768	4209370	97.86	4259876	3255	0.08	44512	31388
18b_27	18b	10611024	0	123398	0	10441206	98.40	10487626	5243813	5243813	10214236	97.39	10309114	8694	0.08	82066	65632
18b_30	18b	2362891	0	37673	0	2332285	98.70	2325218	1162609	1162609	2255220	96.99	2292016	2596	0.11	33538	27813
18b_31	18b	2327347	0	42253	0	2280748	98.00	2285094	1142547	1142547	2200814	96.31	2235728	2767	0.12	32138	26627
18b_32	18b	25847558	0	331894	0	25541330	98.82	25515664	12757832	12757832	24886654	97.53	25181898	27538	0.11	256284	195247
18b_33	18b	5377450	0	65114	0	5306345	98.68	5312336	2656168	2656168	5178078	97.47	5236622	4609	0.09	52484	37529
18b_35	18b	4224926	0	66852	0	4178219	98.89	4158074	2079037	2079037	4042292	97.22	4107556	3811	0.09	54340	41193
18b_37	18b	5013405	0	74347	0	4931027	98.36	4939058	2469529	2469529	4784150	96.86	4852226	4454	0.09	58796	48096
18b_39	18b	9534753	0	130089	0	9251313	97.03	9404664	4702332	4702332	8987822	95.57	9110880	10344	0.11	108246	82542
18b_40	18b	6127851	0	94253	0	6036491	98.51	6033598	3016799	3016799	5849930	96.96	5936086	6152	0.10	78086	62804
18b_42	18b	6084990	0	86348	0	5920725	97.30	5998642	2999321	2999321	5747430	95.81	5828360	6017	0.10	70780	56643
18b_45	18b	2625364	0	32318	0	2592857	98.76	2593046	1296523	1296523	2531538	97.63	2558316	2223	0.09	24186	19212
18b_46	18b	2722700	0	33906	0	2688227	98.73	2688794	1344397	1344397	2622252	97.53	2651980	2341	0.09	27232	21232
18b_47	18b	1832057	0	16601	0	1793940	97.92	1815456	907728	907728	1760530	96.97	1775316	2023	0.11	11676	8406
18b_48	18b	661456	0	7754	0	650713	98.38	653702	326851	326851	635976	97.29	642186	773	0.12	5636	4624
18b_49	18b	1117082	0	12712	0	1103339	98.77	1104370	552185	552185	1076588	97.48	1089416	1211	0.11	10690	7768
18c_100	18c	2390106	0	42418	0	2383575	99.73	2347688	1173844	1173844	2283174	97.25	2338796	2361	0.10	48920	41522
18c_51	18c	7012	0	314	0	6782	96.72	6698	3349	3349	4690	70.02	6250	218	3.25	1494	1325
18c_52	18c	241271	0	3713	0	240416	99.65	237558	118779	118779	231630	97.50	236432	271	0.11	4316	3719
18c_53	18c	284903	0	3263	0	284101	99.72	281640	140820	140820	274748	97.55	280240	598	0.21	5154	3953
18c_54	18c	465628	0	5404	0	464547	99.77	460224	230112	230112	451646	98.14	458646	497	0.11	6124	5078
18c_55	18c	3509295	0	44827	0	3502831	99.82	3464468	1732234	1732234	3399318	98.12	3455432	2572	0.07	50552	40281
18c_56	18c	3066560	0	38598	0	3059951	99.78	3027962	1513981	1513981	2968078	98.02	3018444	2909	0.10	43198	34381
18c_57	18c	31457	0	433	0	31174	99.10	31024	15512	15512	29422	94.84	30644	97	0.31	1148	931
18c_58	18c	145227	0	2099	0	144809	99.71	143128	71564	71564	139016	97.13	142372	338	0.24	3004	2641
18c_59	18c	37537	0	749	0	36992	98.55	36788	18394	18394	33796	91.87	36026	217	0.59	2078	1868
18c_60	18c	1339768	0	16584	0	1337265	99.81	1323184	661592	661592	1301612	98.37	1320000	681	0.05	16352	12788
18c_61	18c	469700	0	5880	0	468429	99.73	463820	231910	231910	455078	98.12	462182	367	0.08	6596	5207
18c_62	18c	37038	0	948	0	36683	99.04	36090	18045	18045	33722	93.44	35478	257	0.71	1604	1413
18c_63	18c	748488	0	11730	0	746883	99.79	736758	368379	368379	717414	97.37	734326	827	0.11	15156	12340
18c_64	18c	249979	0	4133	0	248934	99.58	245846	122923	122923	238286	96.92	244500	301	0.12	5880	4941
18c_65	18c	349359	0	4821	0	348710	99.81	344538	172269	172269	336018	97.53	343570	319	0.09	6818	5326
18c_66	18c	1581156	0	18392	0	1577384	99.76	1562764	781382	781382	1534546	98.19	1557310	1682	0.11	20004	16765
18c_67	18c	43848	0	888	0	43604	99.44	42960	21480	21480	40800	94.97	42552	164	0.38	1690	1488
18c_68	18c	1444815	0	19509	0	1442163	99.82	1425306	712653	712653	1400828	98.28	1421562	1092	0.08	17936	13687
18c_70	18c	799047	0	11737	0	797785	99.84	787310	393655	393655	769468	97.73	785558	490	0.06	12654	10168
18c_71	18c	1234575	0	19783	0	1231843	99.78	1214792	607396	607396	1188086	97.80	1211208	852	0.07	20756	16805
18c_72	18c	195412	0	3518	0	194373	99.47	191894	95947	95947	183918	95.84	190160	695	0.36	5600	4998
18c_73	18c	1587123	0	28615	0	1583289	99.76	1558508	779254	779254	1518640	97.44	1553502	1172	0.08	30122	25878
18c_74	18c	12316	0	362	0	12121	98.42	11954	5977	5977	10248	85.73	11576	183	1.53	1282	1193
18c_75	18c	301590	0	6054	0	301001	99.80	295536	147768	147768	285368	96.56	294566	381	0.13	8440	7406
18c_76	18c	370365	0	6855	0	369236	99.70	363510	181755	181755	351704	96.75	361972	409	0.11	9304	7712
18c_77	18c	426904	0	7200	0	425860	99.76	419704	209852	209852	410768	97.87	418194	466	0.11	6582	5449
18c_78	18c	954018	0	25882	0	951756	99.76	928136	464068	464068	891206	96.02	924766	1108	0.12	31262	27357
18c_79	18c	3098932	0	75458	0	3091751	99.77	3023474	1511737	1511737	2916814	96.47	3014000	2293	0.08	87404	77023
18c_81	18c	4363249	0	75729	0	4351686	99.73	4287520	2143760	2143760	4179922	97.49	4272710	3247	0.08	84374	68873
18c_82	18c	127631	0	2787	0	126862	99.40	124844	62422	62422	119384	95.63	123778	297	0.24	4126	3416
18c_83	18c	426886	0	9690	0	425526	99.68	417196	208598	208598	403732	96.77	415224	612	0.15	10378	8828
18c_84	18c	566048	0	13142	0	564265	99.69	552906	276453	276453	529264	95.72	550192	931	0.17	19866	17521
18c_85	18c	324797	0	5717	0	323731	99.67	319080	159540	159540	309696	97.06	317660	354	0.11	7388	6077
18c_86	18c	772518	0	16136	0	770900	99.79	756382	378191	378191	732208	96.80	754236	528	0.07	19974	17252
18c_87	18c	783085	0	17901	0	781019	99.74	765184	382592	382592	743438	97.16	762582	536	0.07	16970	14276
18c_88	18c	538896	0	12828	0	536565	99.57	526068	263034	263034	506124	96.21	522700	1037	0.20	15228	13050
18c_89	18c	2275374	0	43138	0	2269802	99.76	2232236	1116118	1116118	2175562	97.46	2225188	1476	0.07	45306	38730
18c_90	18c	183593	0	3579	0	183140	99.75	180014	90007	90007	174336	96.85	179354	207	0.11	4682	4096
18c_91	18c	597034	0	8006	0	595613	99.76	589028	294514	294514	578860	98.27	587148	459	0.08	7402	5647
18c_92	18c	353215	0	3861	0	351602	99.54	349354	174677	174677	342996	98.18	347358	383	0.11	4030	3413
18c_94	18c	1291865	0	22105	0	1288817	99.76	1269760	634880	634880	1235048	97.27	1265630	1082	0.09	27172	23348
18c_95	18c	514184	0	7844	0	512869	99.74	506340	253170	253170	494744	97.71	504604	421	0.08	9000	6753
18c_96	18c	2836	0	126	0	2740	96.61	2710	1355	1355	1800	66.42	2552	62	2.29	720	679
18c_97	18c	613448	0	10626	0	611576	99.69	602822	301411	301411	587978	97.54	600234	716	0.12	11212	9301
18c_98	18c	6083428	0	105934	0	6070787	99.79	5977494	2988747	2988747	5833456	97.59	5961032	3821	0.06	112764	96004
18c_99	18c	174545	0	2937	0	174184	99.79	171608	85804	85804	167640	97.69	171088	159	0.09	3174	2485
19a_01	19a	1015859	0	7719	0	976513	96.13	1008140	504070	504070	960882	95.31	967290	1504	0.15	6044	3408
19a_02	19a	1919445	0	28831	0	1892524	98.60	1890614	945307	945307	1844372	97.55	1862172	1521	0.08	15850	10508
19a_03	19a	6715446	0	73842	0	6659303	99.16	6641604	3320802	3320802	6511604	98.04	6580538	4923	0.07	60774	44765
19a_04	19a	6467991	0	69981	0	6388092	98.76	6398010	3199005	3199005	6251950	97.72	6312114	5997	0.09	48784	34336
19a_05	19a	616322	0	4528	0	417104	67.68	611794	305897	305897	398106	65.07	406160	6416	1.05	7630	4433
19a_06	19a	1422754	0	15778	0	1367570	96.12	1406976	703488	703488	1332024	94.67	1348318	3474	0.25	14932	11664
19a_07	19a	7277116	0	71714	0	7229482	99.35	7205402	3602701	3602701	7093782	98.45	7150928	6840	0.09	48216	35216
19a_08	19a	477158	0	3676	0	447554	93.80	473482	236741	236741	439818	92.89	442968	910	0.19	3048	1650
19a_09	19a	154639	0	2035	0	140432	90.81	152604	76302	76302	137082	89.83	138094	303	0.20	404	274
19a_10	19a	509663	0	5541	0	469960	92.21	504122	252061	252061	457080	90.67	462956	1463	0.29	5584	3587
19a_11	19a	1880684	0	21174	0	1800850	95.76	1859510	929755	929755	1759730	94.63	1777290	2386	0.13	16386	11204
19a_12	19a	6425332	0	76118	0	6291007	97.91	6349214	3174607	3174607	6144734	96.78	6208722	6167	0.10	53820	41964
19a_13	19a	2246786	0	25356	0	2082615	92.69	2221430	1110715	1110715	2030184	91.39	2051694	5565	0.25	18994	12010
19a_14	19a	1924834	0	19932	0	1824478	94.79	1904902	952451	952451	1786112	93.76	1799632	4914	0.26	11114	7499
19a_15	19a	3777144	0	59208	0	3728691	98.72	3717936	1858968	1858968	3609238	97.08	3665094	4389	0.12	48822	39270
19a_16	19a	493911	0	5217	0	485690	98.34	488694	244347	244347	477412	97.69	479858	615	0.13	1878	1300
19a_17	19a	463659	0	5581	0	436065	94.05	458078	229039	229039	424522	92.67	429698	786	0.17	5040	3454
19a_18	19a	1235055	0	15231	0	1197048	96.92	1219824	609912	609912	1169258	95.85	1180478	1339	0.11	9752	6014
19a_19	19a	265935	0	1957	0	178385	67.08	263978	131989	131989	170490	64.58	173102	3326	1.26	1686	938
19a_20	19a	1235797	0	12191	0	1200703	97.16	1223606	611803	611803	1175908	96.10	1187126	1386	0.11	8222	4814
19a_21	19a	421036	0	3374	0	217675	51.70	417662	208831	208831	203018	48.61	208822	5479	1.31	4914	2834
19a_22	19a	1037439	0	10955	0	1002701	96.65	1026484	513242	513242	983168	95.78	990710	1036	0.10	6966	4732
19a_23	19a	796489	0	7589	0	740996	93.03	788900	394450	394450	722252	91.55	730914	2493	0.32	7980	4211
19a_24	19a	253099	0	2675	0	238101	94.07	250424	125212	125212	229386	91.60	234160	1266	0.51	4578	3362
19a_25	19a	378241	0	3789	0	363492	96.10	374452	187226	187226	357714	95.53	359360	343	0.09	1388	935
19a_26	19a	1049172	0	10456	0	1019673	97.19	1038716	519358	519358	996542	95.94	1007508	1709	0.16	10010	6459
19a_27	19a	4964446	0	59870	0	4942214	99.55	4904576	2452288	2452288	4828212	98.44	4878824	3520	0.07	45446	29020
19a_28	19a	675515	0	9731	0	660201	97.73	665784	332892	332892	639464	96.05	649016	1454	0.22	8694	6127
19a_29	19a	808770	0	10352	0	790239	97.71	798418	399209	399209	768068	96.20	778140	1747	0.22	9644	7931
19a_30	19a	241678	0	2890	0	220138	91.09	238788	119394	119394	208542	87.33	214126	3122	1.31	5386	4466
19a_31	19a	1135972	0	14060	0	1126492	99.17	1121912	560956	560956	1102114	98.24	1111674	758	0.07	8378	5216
19a_32	19a	324801	0	2523	0	312539	96.22	322278	161139	161139	307052	95.28	309596	420	0.13	2180	1768
19a_33	19a	84724	0	704	0	71799	84.74	84020	42010	42010	69558	82.79	70256	839	1.00	680	436
19a_34	19a	451881	0	3691	0	444329	98.33	448190	224095	224095	437656	97.65	439818	820	0.18	1776	947
19a_35	19a	407194	0	3134	0	399637	98.14	404060	202030	202030	392530	97.15	396030	473	0.12	2786	2115
19a_36	19a	291230	0	1602	0	278935	95.78	289628	144814	144814	274336	94.72	276342	991	0.34	1692	1081
19a_37	19a	433307	0	4131	0	421232	97.21	429176	214588	214588	411190	95.81	416510	591	0.14	4066	2672
19a_38	19a	1726293	0	18619	0	1720017	99.64	1707674	853837	853837	1684708	98.66	1700368	1030	0.06	14082	10639
19a_39	19a	1265434	0	12126	0	1260881	99.64	1253308	626654	626654	1237862	98.77	1247768	987	0.08	8970	5691
19a_40	19a	78019	0	979	0	73947	94.78	77040	38520	38520	71564	92.89	72754	214	0.28	614	388
19a_41	19a	14836	0	144	0	12965	87.39	14692	7346	7346	11948	81.32	12600	221	1.50	632	583
19a_42	19a	14481	0	127	0	10020	69.19	14354	7177	7177	9194	64.05	9610	283	1.97	402	348
19a_43	19a	52996	0	904	0	48671	91.84	52092	26046	26046	47164	90.54	47622	145	0.28	444	382
19a_44	19a	496546	0	4800	0	491144	98.91	491746	245873	245873	481766	97.97	485540	804	0.16	3224	2004
19a_45	19a	174735	0	1327	0	169608	97.07	173408	86704	86704	165466	95.42	167914	367	0.21	2066	1260
19a_46	19a	912860	0	6832	0	906907	99.35	906028	453014	453014	893898	98.66	899242	833	0.09	4744	3118
19a_47	19a	255141	0	2433	0	249569	97.82	252708	126354	126354	240648	95.23	245678	1458	0.58	4712	3785
19a_48	19a	14311	0	141	0	11289	78.88	14170	7085	7085	9592	67.69	10664	484	3.42	1016	714
19a_49	19a	194949	0	1213	0	66720	34.22	193736	96868	96868	59042	30.48	61892	3615	1.87	2676	735
19a_50	19a	1098699	0	13927	0	1044534	95.07	1084772	542386	542386	1014752	93.55	1027358	3249	0.30	11892	7971
19b_01	19b	1894869	0	27449	0	1879699	99.20	1867420	933710	933710	1823188	97.63	1850372	1878	0.10	24674	21133
19b_02	19b	1275528	0	13156	0	1269092	99.50	1262372	631186	631186	1243558	98.51	1254922	1014	0.08	9706	6947
19b_03	19b	536611	0	6259	0	527917	98.38	530352	265176	265176	514566	97.02	520974	684	0.13	5994	4240
19b_04	19b	479903	0	6429	0	467824	97.48	473474	236737	236737	455048	96.11	461034	361	0.08	5450	3914
19b_05	19b	146360	0	1930	0	121685	83.14	144430	72215	72215	116268	80.50	119010	745	0.52	2646	2133
19b_06	19b	1729876	0	26420	0	1699912	98.27	1703456	851728	851728	1645734	96.61	1671736	1756	0.10	21418	15360
19b_08	19b	123706	0	2144	0	95395	77.11	121562	60781	60781	88888	73.12	92528	723	0.59	3592	3109
19b_09	19b	3881594	0	57564	0	3855054	99.32	3824030	1912015	1912015	3744702	97.93	3794850	2640	0.07	44452	35373
19b_11	19b	423725	0	7167	0	404677	95.50	416558	208279	208279	390434	93.73	396730	780	0.19	5706	4355
19b_13	19b	1984902	0	25784	0	1971856	99.34	1959118	979559	979559	1922096	98.11	1944646	1426	0.07	19724	15205
19b_14	19b	655077	0	8327	0	642762	98.12	646750	323375	323375	625582	96.73	633574	861	0.13	7490	5411
19b_15	19b	636538	0	10970	0	621749	97.68	625568	312784	312784	598236	95.63	609886	893	0.14	10508	8709
19b_16	19b	3231497	0	51701	0	3211846	99.39	3179796	1589898	1589898	3107678	97.73	3157662	2483	0.08	44138	35136
19b_19	19b	1566262	0	32084	0	1547032	98.77	1534178	767089	767089	1480890	96.53	1513198	1750	0.11	29582	25155
19b_20	19b	267359	0	4757	0	255161	95.44	262602	131301	131301	243952	92.90	249956	448	0.17	5306	4001
19b_21	19b	2325279	0	46945	0	2316579	99.63	2278334	1139167	1139167	2224076	97.62	2268172	1462	0.06	39348	33141
19b_23	19b	317911	0	7121	0	304028	95.63	310790	155395	155395	288594	92.86	296156	751	0.24	6916	5919
19b_25	19b	700595	0	12357	0	689880	98.47	688238	344119	344119	661030	96.05	676622	901	0.13	12900	10890
19b_26	19b	1901237	0	20423	0	1881413	98.96	1880814	940407	940407	1838324	97.74	1859210	1780	0.09	18702	14008
19b_29	19b	35761	0	123	0	9156	25.60	35638	17819	17819	7744	21.73	8154	879	2.47	402	320
19b_30	19b	1063369	0	20105	0	1044322	98.21	1043264	521632	521632	1006938	96.52	1023004	1213	0.12	14800	12561
19b_31	19b	649577	0	9547	0	624076	96.07	640030	320015	320015	602202	94.09	612818	1711	0.27	9428	6660
19b_32	19b	4333495	0	73043	0	4308647	99.43	4260452	2130226	2130226	4164274	97.74	4232310	3294	0.08	59056	46083
19b_33	19b	872351	0	17349	0	860542	98.65	855002	427501	427501	825572	96.56	842042	1151	0.13	15140	12392
19b_34	19b	3301912	0	57962	0	3283030	99.43	3243950	1621975	1621975	3158346	97.36	3222258	2810	0.09	55510	46921
19b_35	19b	2240240	0	35528	0	2221074	99.14	2204712	1102356	1102356	2152902	97.65	2183892	1654	0.08	27936	21717
19b_36	19b	1022295	0	13923	0	999736	97.79	1008372	504186	504186	972922	96.48	984810	1003	0.10	10206	7569
19b_37	19b	94304	0	1178	0	68875	73.04	93126	46563	46563	64866	69.65	67156	541	0.58	2020	1445
19b_38	19b	316037	0	6073	0	282391	89.35	309964	154982	154982	269758	87.03	275450	868	0.28	4876	3804
19b_39	19b	2167165	0	20451	0	2145188	98.99	2146714	1073357	1073357	2102530	97.94	2122600	2137	0.10	17166	12633
19b_40	19b	1456322	0	30998	0	1438772	98.79	1425324	712662	712662	1376172	96.55	1406360	1414	0.10	28272	21873
19b_42	19b	23162	0	264	0	8317	35.91	22898	11449	11449	7146	31.21	7748	305	1.33	582	501
19b_43	19b	1520951	0	29699	0	1504774	98.94	1491252	745626	745626	1443464	96.80	1473550	1525	0.10	25718	21786
19b_44	19b	694605	0	11821	0	681655	98.14	682784	341392	341392	658464	96.44	668866	968	0.14	9498	7598
19b_45	19b	591010	0	9114	0	574512	97.21	581896	290948	290948	554396	95.27	564646	752	0.13	9378	7303
19b_46	19b	941722	0	16522	0	908721	96.50	925200	462600	462600	873160	94.38	890664	1535	0.17	14244	11795
19b_47	19b	2842923	0	51333	0	2817831	99.12	2791590	1395795	1395795	2715360	97.27	2764118	2380	0.09	43952	36042
19b_48	19b	547113	0	12137	0	499066	91.22	534976	267488	267488	470692	87.98	485378	1551	0.29	13918	11372
19b_50	19b	4367162	0	85970	0	4345023	99.49	4281192	2140596	2140596	4162602	97.23	4255196	3857	0.09	84654	68383
19cd_01	19cd	98330	0	1208	0	74478	75.74	97122	48561	48561	71770	73.90	73004	266	0.27	1094	819
19cd_02	19cd	17332818	0	275176	0	17273798	99.66	17057642	8528821	8528821	16760302	98.26	16985866	12756	0.07	203944	158025
19cd_04	19cd	14631350	0	199796	0	14564532	99.54	14431554	7215777	7215777	14170206	98.19	14352340	12396	0.09	165604	126744
19cd_05	19cd	1232981	0	24069	0	1212145	98.31	1208912	604456	604456	1161462	96.07	1186854	1222	0.10	23388	20097
19cd_07	19cd	1009143	0	18373	0	993412	98.44	990770	495385	495385	955820	96.47	973988	1051	0.11	16516	13759
19cd_08	19cd	246316	0	3854	0	208960	84.83	242462	121231	121231	195940	80.81	203044	2062	0.85	6674	5068
19cd_09	19cd	10337405	0	177687	0	10282852	99.47	10159718	5079859	5079859	9942106	97.86	10097568	7597	0.07	140112	106911
19cd_10	19cd	5591412	0	118646	0	5553964	99.33	5472766	2736383	2736383	5306768	96.97	5430164	5154	0.09	108564	92880
19cd_11	19cd	4445894	0	63516	0	4407800	99.14	4382378	2191189	2191189	4282538	97.72	4340446	3838	0.09	51840	40597
19cd_12	19cd	4988514	0	90808	0	4947254	99.17	4897706	2448853	2448853	4764186	97.27	4852588	3858	0.08	82060	64500
19cd_13	19cd	4478698	0	73978	0	4457021	99.52	4404720	2202360	2202360	4312264	97.90	4379868	3175	0.07	61210	49063
19cd_15	19cd	168019	0	1491	0	133231	79.30	166528	83264	83264	128558	77.20	130688	1052	0.63	1924	1383
19cd_19	19cd	175155	0	3829	0	163505	93.35	171326	85663	85663	155232	90.61	159330	346	0.20	3540	3094
19cd_20	19cd	561770	0	12190	0	539857	96.10	549580	274790	274790	513468	93.43	526546	1121	0.20	11918	10690
19cd_21	19cd	4944363	0	93641	0	4894803	99.00	4850722	2425361	2425361	4706690	97.03	4796678	4484	0.09	78014	63764
19cd_23	19cd	154978	0	2738	0	121806	78.60	152240	76120	76120	115224	75.69	118334	734	0.48	2620	2180
19cd_24	19cd	328737	0	6355	0	310900	94.57	322382	161191	161191	297108	92.16	304034	511	0.16	6256	5317
19cd_25	19cd	935402	0	15622	0	902454	96.48	919780	459890	459890	866776	94.24	885490	1342	0.15	16258	13203
19cd_26	19cd	3418246	0	49332	0	3389183	99.15	3368914	1684457	1684457	3291604	97.71	3336262	3589	0.11	40472	32641
19cd_27	19cd	1906490	0	34808	0	1883165	98.78	1871682	935841	935841	1816080	97.03	1846408	1949	0.10	26948	21656
19cd_28	19cd	1783724	0	27504	0	1769225	99.19	1756220	878110	878110	1712424	97.51	1740158	1563	0.09	25124	20846
19cd_29	19cd	204314	0	2620	0	174059	85.19	201694	100847	100847	167682	83.14	170806	633	0.31	3050	2192
19cd_30	19cd	2654046	0	53422	0	2620654	98.74	2600624	1300312	1300312	2510808	96.55	2565038	2194	0.08	48334	39634
19cd_31	19cd	2921068	0	53766	0	2885276	98.77	2867302	1433651	1433651	2773658	96.73	2828268	3242	0.11	51112	41344
19cd_32	19cd	447963	0	7997	0	426964	95.31	439966	219983	219983	409254	93.02	418504	463	0.11	8276	7292
19cd_33	19cd	393224	0	6566	0	375571	95.51	386658	193329	193329	360166	93.15	368016	989	0.26	7200	5895
19cd_34	19cd	2380016	0	41484	0	2369933	99.58	2338532	1169266	1169266	2283592	97.65	2326546	1903	0.08	37770	30464
19cd_35	19cd	1098200	0	12358	0	1063985	96.88	1085842	542921	542921	1037798	95.58	1050138	1489	0.14	11614	8839
19cd_36	19cd	546023	0	7153	0	514894	94.30	538870	269435	269435	497898	92.40	506604	1137	0.21	7266	6017
19cd_37	19cd	394676	0	6672	0	354407	89.80	388004	194002	194002	337256	86.92	346004	1731	0.45	8090	6677
19cd_38	19cd	3084872	0	48858	0	3047456	98.79	3036014	1518007	1518007	2953240	97.27	2996092	2506	0.08	40180	33315
19cd_39	19cd	990840	0	18204	0	959856	96.87	972636	486318	486318	921040	94.70	940272	1380	0.14	17508	14491
19cd_40	19cd	1668919	0	27409	0	1644250	98.52	1641510	820755	820755	1588862	96.79	1614834	2007	0.12	24282	19512
19cd_41	19cd	1726718	0	23586	0	1696504	98.25	1703132	851566	851566	1648450	96.79	1670430	2488	0.15	20452	16107
19cd_42	19cd	48890	0	522	0	43037	88.03	48368	24184	24184	41126	85.03	42156	359	0.74	1014	860
19cd_45	19cd	2627985	0	37779	0	2610568	99.34	2590206	1295103	1295103	2536660	97.93	2571024	1765	0.07	30394	24140
19cd_47	19cd	544144	0	7410	0	535014	98.32	536734	268367	268367	519606	96.81	527046	558	0.10	6330	4854
19cd_48	19cd	1393770	0	22262	0	1386820	99.50	1371508	685754	685754	1342770	97.90	1363566	992	0.07	17856	14420
19cd_49	19cd	415487	0	5489	0	396141	95.34	409998	204999	204999	383998	93.66	389902	750	0.18	5812	4986
19cd_50	19cd	2360457	0	29933	0	2337553	99.03	2330524	1165262	1165262	2274874	97.61	2305482	2138	0.09	26680	20684
20a_03	20a	841906	0	11562	0	839052	99.66	830344	415172	415172	815868	98.26	826652	838	0.10	9398	7534
20a_06	20a	591278	0	6212	0	588991	99.61	585066	292533	292533	575268	98.33	582058	721	0.12	6138	4552
20a_09	20a	378842	0	5058	0	377492	99.64	373784	186892	186892	366878	98.15	371768	666	0.18	4500	3669
20a_12	20a	435658	0	4486	0	434192	99.66	431172	215586	215586	424460	98.44	429202	504	0.12	4396	3324
20a_13	20a	204435	0	2111	0	202741	99.17	202324	101162	101162	195510	96.63	199610	1020	0.50	3760	3058
20a_14	20a	18650	0	670	0	17976	96.39	17980	8990	8990	14254	79.28	16844	462	2.57	2486	2263
20a_15	20a	347315	0	4021	0	345779	99.56	343294	171647	171647	337536	98.32	341256	502	0.15	3536	2588
20a_18	20a	342057	0	4313	0	340869	99.65	337744	168872	168872	332188	98.35	336156	400	0.12	3614	2951
20a_30	20a	1161773	0	11413	0	1159166	99.78	1150360	575180	575180	1135508	98.71	1146656	1097	0.10	8816	6366
20a_31	20a	79383	0	1189	0	78618	99.04	78194	39097	39097	75266	96.26	77004	425	0.54	1498	1275
20a_37	20a	243469	0	3411	0	241815	99.32	240058	120029	120029	232988	97.05	237672	732	0.30	4300	3616
20a_38	20a	53087	0	875	0	51438	96.89	52212	26106	26106	46254	88.59	49658	905	1.73	3214	2862
20a_41	20a	126032	0	1870	0	124150	98.51	124162	62081	62081	118372	95.34	121834	446	0.36	3220	2707
20a_43	20a	12443	0	377	0	11846	95.20	12066	6033	6033	9594	79.51	11052	417	3.46	1326	1162
20a_47	20a	2922269	0	48945	0	2917588	99.84	2873324	1436662	1436662	2823734	98.27	2865952	2691	0.09	38198	23752
20a_48	20a	292106	0	5906	0	290082	99.31	286200	143100	143100	276074	96.46	283540	636	0.22	6554	5478
23p_10	23p	153613	0	1411	0	152889	99.53	152202	76101	76101	149322	98.11	151148	330	0.22	1652	1430
23p_21	23p	29579	0	451	0	29037	98.17	29128	14564	14564	26596	91.31	28314	272	0.93	1614	1454
23p_45	23p	1081756	0	10978	0	1079472	99.79	1070778	535389	535389	1057706	98.78	1067524	970	0.09	7908	5536
23p_46	23p	1246266	0	16562	0	1243051	99.74	1229704	614852	614852	1210026	98.40	1224936	1553	0.13	13694	10776
23p_47	23p	714217	0	7993	0	711556	99.63	706224	353112	353112	693366	98.18	702228	1335	0.19	8224	6525
23p_51	23p	4741252	0	84908	0	4731446	99.79	4656344	2328172	2328172	4567562	98.09	4642120	4418	0.09	65570	53564
23p_55	23p	950175	0	10987	0	946950	99.66	939188	469594	469594	922850	98.26	934466	1497	0.16	10716	8404
23p_57	23p	1174746	0	17524	0	1169441	99.55	1157222	578611	578611	1135994	98.17	1150630	1287	0.11	13348	10273
23p_59	23p	1614492	0	16358	0	1611460	99.81	1598134	799067	799067	1577974	98.74	1593370	1732	0.11	13392	9281
23p_60	23p	1288031	0	16575	0	1285388	99.79	1271456	635728	635728	1253500	98.59	1267608	1205	0.09	12156	9939
23p_61	23p	833835	0	9173	0	831210	99.69	824662	412331	412331	812912	98.58	821032	1005	0.12	7388	5756
23p_62	23p	1730607	0	22957	0	1727706	99.83	1707650	853825	853825	1680098	98.39	1703224	1525	0.09	21258	15730
23p_63	23p	2573895	0	44231	0	2569392	99.83	2529664	1264832	1264832	2477292	97.93	2522986	2175	0.09	41548	33023
23p_64	23p	3627339	0	48057	0	3621875	99.85	3579282	1789641	1789641	3525970	98.51	3571188	2630	0.07	39932	30402
23p_65	23p	3434041	0	64319	0	3425545	99.75	3369722	1684861	1684861	3298596	97.89	3358078	3148	0.09	54142	45033
23p_66	23p	1294960	0	15648	0	1292122	99.78	1279312	639656	639656	1260890	98.56	1275284	1190	0.09	13734	10388
23p_67	23p	498446	0	4664	0	497131	99.74	493782	246891	246891	486604	98.55	491660	807	0.16	4380	3125
23p_68	23p	955643	0	14427	0	953915	99.82	941216	470608	470608	925372	98.32	938650	838	0.09	11764	8384
23p_69	23p	1191844	0	19064	0	1189825	99.83	1172780	586390	586390	1152034	98.23	1169600	1161	0.10	16104	12176
23p_70	23p	2416784	0	35926	0	2411204	99.77	2380858	1190429	1190429	2339544	98.26	2373318	1960	0.08	28482	21763
23p_71	23p	3558319	0	58069	0	3550554	99.78	3500250	1750125	1750125	3441342	98.32	3488934	3551	0.10	43524	34575
23p_72	23p	2057833	0	46923	0	2053532	99.79	2010910	1005455	1005455	1955118	97.23	2004532	2077	0.10	44552	35710
23p_73	23p	3574121	0	62771	0	3568235	99.84	3511350	1755675	1755675	3440054	97.97	3502112	3352	0.10	56118	45481
23p_74	23p	2960209	0	39571	0	2955085	99.83	2920638	1460319	1460319	2875336	98.45	2912682	2832	0.10	33672	26277
23p_75	23p	1195430	0	11188	0	1193626	99.85	1184242	592121	592121	1171192	98.90	1181466	972	0.08	9296	6720
23p_76	23p	3440709	0	49923	0	3434463	99.82	3390786	1695393	1695393	3337892	98.44	3381436	3104	0.09	39582	30187
23p_77	23p	3810475	0	67941	0	3803206	99.81	3742534	1871267	1871267	3673534	98.16	3732390	2875	0.08	53176	41099
23p_78	23p	1070234	0	21210	0	1067084	99.71	1049024	524512	524512	1023048	97.52	1044408	1466	0.14	18656	15260
23p_79	23p	3663983	0	65637	0	3658411	99.85	3598346	1799173	1799173	3524246	97.94	3590126	2648	0.07	59722	48273
23p_80	23p	898063	0	19151	0	895951	99.76	878912	439456	439456	858876	97.72	875670	1130	0.13	15200	12237
23p_81	23p	3715238	0	72576	0	3707560	99.79	3642662	1821331	1821331	3561614	97.78	3631184	3800	0.10	61246	49655
23p_82	23p	880961	0	12883	0	878546	99.73	868078	434039	434039	853202	98.29	864500	1163	0.13	10402	8006
23p_83	23p	1394458	0	14048	0	1392226	99.84	1380410	690205	690205	1363368	98.77	1376678	1500	0.11	11292	7935
23p_84	23p	1812355	0	24671	0	1809477	99.84	1787684	893842	893842	1763620	98.65	1783366	1440	0.08	17218	13122
23p_85	23p	1343047	0	17169	0	1339925	99.77	1325878	662939	662939	1304310	98.37	1321482	1274	0.10	15732	11268
23p_86	23p	1100176	0	18258	0	1097514	99.76	1081918	540959	540959	1058546	97.84	1078154	1102	0.10	17882	14926
23p_87	23p	1818979	0	19809	0	1814343	99.75	1799170	899585	899585	1774242	98.61	1792352	2182	0.12	16198	12213
23p_88	23p	2204387	0	28795	0	2200648	99.83	2175592	1087796	1087796	2141646	98.44	2169970	1883	0.09	25638	20067
23p_89	23p	3759779	0	46371	0	3753892	99.84	3713408	1856704	1856704	3659090	98.54	3704124	3397	0.09	39642	27084
23p_90	23p	2449748	0	28004	0	2445244	99.82	2421744	1210872	1210872	2386726	98.55	2414258	2982	0.12	25390	17737
23p_91	23p	781213	0	5497	0	780180	99.87	775716	387858	387858	767676	98.96	773890	793	0.10	5104	3127
23p_92	23p	825571	0	12037	0	824108	99.82	813534	406767	406767	800670	98.42	811310	761	0.09	9098	6280
23p_93	23p	1175474	0	14864	0	1173755	99.85	1160610	580305	580305	1144080	98.58	1157906	985	0.08	12418	9139
23p_94	23p	1368387	0	16975	0	1366007	99.83	1351412	675706	675706	1330736	98.47	1347908	1124	0.08	14786	9986
23p_95	23p	4363205	0	50243	0	4354928	99.81	4312962	2156481	2156481	4245446	98.43	4300282	4403	0.10	45638	33377
23p_96	23p	1198551	0	13121	0	1196083	99.79	1185430	592715	592715	1168934	98.61	1181856	1106	0.09	11314	7853
23p_97	23p	2325443	0	34735	0	2318806	99.71	2290708	1145354	1145354	2247224	98.10	2281176	2895	0.13	30138	23000
25c_01	25c	1422585	0	14271	0	1417024	99.61	1408314	704157	704157	1388444	98.59	1401430	1323	0.09	11634	9033
25c_02	25c	1037595	0	11549	0	1032923	99.55	1026046	513023	513023	1010430	98.48	1020680	694	0.07	8576	6631
25c_09	25c	3680655	0	44603	0	3664228	99.55	3636052	1818026	1818026	3576220	98.35	3617272	2353	0.06	36166	27643
25c_10	25c	3599278	0	42530	0	3587597	99.68	3556748	1778374	1778374	3508752	98.65	3542258	2809	0.08	29992	24950
25c_11	25c	3919854	0	49944	0	3907043	99.67	3869910	1934955	1934955	3810984	98.48	3854534	2565	0.07	36546	27575
25c_13	25c	5681642	0	81278	0	5668302	99.77	5600364	2800182	2800182	5512728	98.44	5583026	3998	0.07	60588	46306
25c_14	25c	988092	0	12304	0	977055	98.88	975788	487894	487894	951202	97.48	963740	1011	0.10	10582	7773
25c_20	25c	833428	0	7534	0	821681	98.59	825894	412947	412947	806252	97.62	813094	1053	0.13	5784	4058
25c_21	25c	335722	0	5200	0	332040	98.90	330522	165261	165261	321850	97.38	326410	430	0.13	4230	3395
25c_22	25c	2435343	0	32401	0	2426511	99.64	2402942	1201471	1201471	2366410	98.48	2392334	1776	0.07	21420	15734
25c_24	25c	2207612	0	32994	0	2189979	99.20	2174618	1087309	1087309	2129068	97.91	2155566	1419	0.07	22962	18386
25c_27	25c	1430957	0	21055	0	1421700	99.35	1409902	704951	704951	1378826	97.80	1399382	1263	0.09	18722	14640
25c_29	25c	1321399	0	23465	0	1310402	99.17	1297934	648967	648967	1259712	97.06	1285834	1103	0.08	22300	18622
25c_30	25c	1937450	0	26010	0	1910932	98.63	1911440	955720	955720	1856488	97.13	1883094	1828	0.10	23910	18096
25c_32	25c	994644	0	14966	0	986170	99.15	979678	489839	489839	956508	97.63	970444	760	0.08	11964	9765
25c_35	25c	2023172	0	26998	0	2015281	99.61	1996174	998087	998087	1959734	98.17	1986712	1571	0.08	22856	17610
25c_39	25c	1229892	0	16958	0	1224530	99.56	1212934	606467	606467	1192830	98.34	1206692	880	0.07	12082	8366
25c_40	25c	1445828	0	22248	0	1440182	99.61	1423580	711790	711790	1397948	98.20	1416872	1062	0.07	16472	12641
25c_44	25c	669330	0	12998	0	658152	98.33	656332	328166	328166	635042	96.76	644426	728	0.11	8522	7007
25c_45	25c	2041420	0	28692	0	2030653	99.47	2012728	1006364	1006364	1978568	98.30	2000730	1231	0.06	20066	14489
25c_50	25c	597574	0	10640	0	589963	98.73	586934	293467	293467	568392	96.84	578572	751	0.13	8706	6558
25c_52	25c	3040337	0	42263	0	3025202	99.50	2998074	1499037	1499037	2941472	98.11	2980842	2097	0.07	33806	27343
25c_53	25c	242394	0	4790	0	233519	96.34	237604	118802	118802	223290	93.98	227950	779	0.33	4104	3547
25c_55	25c	3578959	0	53591	0	3561713	99.52	3525368	1762684	1762684	3446562	97.76	3505088	3034	0.09	53626	40077
25c_57	25c	3128322	0	69978	0	3109501	99.40	3058344	1529172	1529172	2961624	96.84	3037020	2503	0.08	69358	56474
25c_60	25c	2410675	0	31991	0	2375965	98.56	2378684	1189342	1189342	2315482	97.34	2341936	2038	0.09	24102	19507
25c_64	25c	4018862	0	78340	0	4002303	99.59	3940522	1970261	1970261	3847916	97.65	3920782	3181	0.08	64902	53252
25c_65	25c	4488911	0	77025	0	4472708	99.64	4411886	2205943	2205943	4317452	97.86	4392192	3491	0.08	67436	56735
25c_72	25c	1687439	0	31461	0	1670341	98.99	1655978	827989	827989	1608752	97.15	1637462	1418	0.09	24308	19983
25c_76	25c	271069	0	6035	0	263691	97.28	265034	132517	132517	251582	94.92	257056	600	0.23	4622	3918
25c_77	25c	2061077	0	30079	0	2052185	99.57	2030998	1015499	1015499	1990856	98.02	2020584	1522	0.07	24710	20162
25c_78	25c	2433593	0	43863	0	2422790	99.56	2389730	1194865	1194865	2335986	97.75	2377078	1849	0.08	36120	29501
25c_79	25c	710816	0	12806	0	706643	99.41	698010	349005	349005	682186	97.73	693280	557	0.08	9978	7811
25c_81	25c	3908249	0	78339	0	3899502	99.78	3829910	1914955	1914955	3742160	97.71	3818750	2413	0.06	70094	59137
25c_82	25c	5245356	0	90988	0	5225544	99.62	5154368	2577184	2577184	5046716	97.91	5130808	3748	0.07	73742	59787
25c_83	25c	4538229	0	90155	0	4526210	99.74	4448074	2224037	2224037	4349810	97.79	4432726	3329	0.07	75788	63537
25c_84	25c	3508749	0	87173	0	3492040	99.52	3421576	1710788	1710788	3311240	96.78	3402150	2717	0.08	82018	69063
25c_91	25c	936079	0	19277	0	930448	99.40	916802	458401	458401	893690	97.48	910312	859	0.09	15512	12318
25c_92	25c	4364654	0	95194	0	4347029	99.60	4269460	2134730	2134730	4149946	97.20	4248934	2901	0.07	89994	75609
25c_93	25c	1048218	0	10480	0	1043112	99.51	1037738	518869	518869	1023980	98.67	1031952	680	0.07	7404	5256
26b_02	26b	3794784	0	59622	0	3784538	99.73	3735162	1867581	1867581	3666220	98.15	3722244	2672	0.07	50942	39093
26b_03	26b	1542220	0	25578	0	1516641	98.34	1516642	758321	758321	1468926	96.85	1489702	1361	0.09	18296	15655
26b_04	26b	1008433	0	18677	0	995260	98.69	989756	494878	494878	956992	96.69	975906	677	0.07	15960	13477
26b_05	26b	653632	0	13174	0	626289	95.82	640458	320229	320229	597470	93.29	611804	1311	0.20	12636	9889
26b_06	26b	4257314	0	73506	0	4196056	98.56	4183808	2091904	2091904	4049934	96.80	4119358	3192	0.08	61222	47664
26b_07	26b	1537221	0	26421	0	1505978	97.97	1510800	755400	755400	1453354	96.20	1478306	1251	0.08	22594	18263
26b_08	26b	1596214	0	25910	0	1566342	98.13	1570304	785152	785152	1513002	96.35	1538342	2090	0.13	22178	17045
26b_09	26b	5134769	0	84577	0	5111650	99.55	5050192	2525096	2525096	4940018	97.82	5022344	4729	0.09	71592	56003
26b_10	26b	3998803	0	58355	0	3981571	99.57	3940448	1970224	1970224	3875412	98.35	3920740	2476	0.06	39892	30760
26b_11	26b	14258	0	150	0	5799	40.67	14108	7054	7054	4748	33.65	5468	181	1.28	692	640
26b_12	26b	5064591	0	64761	0	5024742	99.21	4999830	2499915	2499915	4901048	98.02	4957308	2673	0.05	49616	37944
26b_13	26b	11432478	0	192928	0	11367033	99.43	11239550	5619775	5619775	11008224	97.94	11165912	8193	0.07	141558	115839
26b_15	26b	677489	0	14815	0	652249	96.27	662674	331337	331337	620734	93.67	636520	914	0.14	14082	11892
26b_16	26b	1466706	0	26670	0	1451095	98.94	1440036	720018	720018	1394846	96.86	1422884	1541	0.11	23794	20066
26b_17	26b	23297658	0	293510	0	23229884	99.71	23004148	11502074	11502074	22657456	98.49	22917396	18978	0.08	215678	163349
26b_18	26b	9114503	0	144485	0	9087060	99.70	8970018	4485009	4485009	8806754	98.18	8936066	6509	0.07	108050	85948
26b_19	26b	4590887	0	81951	0	4578114	99.72	4508936	2254468	2254468	4419358	98.01	4493034	3129	0.07	62324	50649
26b_20	26b	3678525	0	57277	0	3665337	99.64	3621248	1810624	1810624	3555964	98.20	3605920	2140	0.06	45020	36869
26b_21	26b	7945656	0	209226	0	7913061	99.59	7736430	3868215	3868215	7483734	96.73	7697148	6687	0.09	193230	168595
26b_22	26b	6052045	0	102525	0	6005679	99.23	5949520	2974760	2974760	5792606	97.36	5898710	4444	0.07	90936	71249
26b_23	26b	3444926	0	66378	0	3417333	99.20	3378548	1689274	1689274	3285636	97.25	3347972	2983	0.09	56924	45679
26b_24	26b	4952052	0	84176	0	4928450	99.52	4867876	2433938	2433938	4757516	97.73	4841038	3236	0.07	77738	64316
26b_25	26b	4186856	0	74518	0	4169932	99.60	4112338	2056169	2056169	4020810	97.77	4092918	2496	0.06	62058	49673
26b_27	26b	5248166	0	80090	0	5234447	99.74	5168076	2584038	2584038	5083986	98.37	5151072	3285	0.06	59900	45917
26b_28	26b	2285052	0	35082	0	2269948	99.34	2249970	1124985	1124985	2198806	97.73	2232968	1898	0.08	29758	24157
26b_30	26b	7738008	0	159898	0	7719030	99.75	7578110	3789055	3789055	7403958	97.70	7553100	6032	0.08	131044	109747
26b_31	26b	3446499	0	60457	0	3428160	99.47	3386042	1693021	1693021	3314172	97.88	3365336	2367	0.07	45266	37287
26b_32	26b	4327136	0	72706	0	4309168	99.58	4254430	2127215	2127215	4163908	97.87	4233516	2946	0.07	64016	51172
26b_33	26b	3577110	0	66656	0	3558979	99.49	3510454	1755227	1755227	3427986	97.65	3489586	2737	0.08	54486	44864
26b_36	26b	3307316	0	91398	0	3294933	99.63	3215918	1607959	1607959	3109002	96.68	3201254	2281	0.07	85050	74487
26b_37	26b	8397130	0	152926	0	8373765	99.72	8244204	4122102	4122102	8065406	97.83	8214280	6559	0.08	134392	112091
26b_39	26b	3965590	0	67456	0	3956227	99.76	3898134	1949067	1949067	3827136	98.18	3885724	3047	0.08	52576	42628
26b_40	26b	11703534	0	202988	0	11681421	99.81	11500546	5750273	5750273	11271666	98.01	11471022	7411	0.06	173294	141354
26b_41	26b	5845904	0	114320	0	5832684	99.77	5731584	2865792	2865792	5602844	97.75	5714704	3660	0.06	99816	81129
26b_42	26b	10268894	0	152746	0	10235531	99.68	10116148	5058074	5058074	9924244	98.10	10076300	6485	0.06	136544	109990
26b_43	26b	4851708	0	110242	0	4835671	99.67	4741466	2370733	2370733	4611508	97.26	4721624	3805	0.08	99086	84043
26b_44	26b	3187199	0	81491	0	3176200	99.65	3105708	1552854	1552854	3005570	96.78	3092228	2481	0.08	77762	67662
26b_45	26b	3758751	0	71805	0	3744437	99.62	3686946	1843473	1843473	3596498	97.55	3669076	3556	0.10	62824	50986
26b_46	26b	8605128	0	158760	0	8588355	99.81	8446368	4223184	4223184	8270910	97.92	8424804	4791	0.06	137428	114689
26b_47	26b	3902482	0	56570	0	3894441	99.79	3845912	1922956	1922956	3784782	98.41	3835304	2567	0.07	45734	35005
26b_49	26b	4683703	0	80635	0	4637408	99.01	4603068	2301534	2301534	4476880	97.26	4553370	3403	0.07	66594	55783
26c_01	26c	420316	0	3000	0	416004	98.97	417316	208658	208658	408130	97.80	412466	538	0.13	3890	2822
26c_02	26c	371990	0	2800	0	370236	99.53	369190	184595	184595	364898	98.84	367124	312	0.08	2100	1505
26c_03	26c	431197	0	4273	0	428331	99.34	426924	213462	213462	420664	98.53	423644	414	0.10	2684	1792
26c_04	26c	378630	0	4014	0	373204	98.57	374616	187308	187308	363904	97.14	368442	748	0.20	3966	2752
26c_05	26c	222056	0	1996	0	215841	97.20	220060	110030	110030	209926	95.39	213242	603	0.27	2878	2396
26c_06	26c	972614	0	9890	0	965130	99.23	962724	481362	481362	944770	98.14	954402	838	0.09	8486	6440
26c_07	26c	162636	0	1736	0	156982	96.52	160900	80450	80450	152524	94.79	154622	624	0.39	1964	1644
26c_08	26c	110002	0	694	0	108277	98.43	109308	54654	54654	105980	96.96	107310	273	0.25	1128	933
26c_09	26c	536352	0	4928	0	533556	99.48	531424	265712	265712	523552	98.52	527970	658	0.12	3820	2475
26c_12	26c	319089	0	3215	0	315240	98.79	315874	157937	157937	307370	97.31	311582	443	0.14	3450	2664
26c_13	26c	987083	0	9183	0	980909	99.37	977900	488950	488950	959918	98.16	970680	1046	0.11	8600	6055
26c_14	26c	781825	0	7969	0	777740	99.48	773856	386928	386928	760964	98.33	768914	857	0.11	7374	5609
26c_15	26c	688440	0	7160	0	678931	98.62	681280	340640	340640	665680	97.71	670996	775	0.11	4280	3249
26c_16	26c	595542	0	5560	0	588956	98.89	589982	294991	294991	577474	97.88	582750	646	0.11	4458	3048
26c_17	26c	85975	0	531	0	77043	89.61	85444	42722	42722	75692	88.59	76256	256	0.30	464	368
26c_18	26c	138514	0	974	0	132666	95.78	137540	68770	68770	129862	94.42	131412	280	0.20	1442	1146
26c_19	26c	447984	0	3436	0	443898	99.09	444548	222274	222274	435804	98.03	439846	616	0.14	3722	2597
26c_20	26c	600870	0	6116	0	596291	99.24	594754	297377	297377	582716	97.98	589596	579	0.10	5294	3552
26c_22	26c	243274	0	2534	0	233010	95.78	240740	120370	120370	226516	94.09	230106	370	0.15	2658	2118
26c_23	26c	1146267	0	11543	0	1133791	98.91	1134724	567362	567362	1110268	97.84	1121324	924	0.08	9174	7276
26c_24	26c	1062552	0	11522	0	1048351	98.66	1051030	525515	525515	1025294	97.55	1035454	1375	0.13	8290	5457
26c_25	26c	1636533	0	18137	0	1619935	98.99	1618396	809198	809198	1582108	97.76	1600420	1378	0.09	15018	11087
26c_26	26c	794757	0	8579	0	783587	98.59	786178	393089	393089	764700	97.27	774044	964	0.12	8588	6621
26c_27	26c	511684	0	4548	0	507128	99.11	507136	253568	253568	497032	98.01	501826	754	0.15	4408	3115
26c_28	26c	2098564	0	22674	0	2090673	99.62	2075890	1037945	1037945	2042360	98.38	2066420	1579	0.08	21282	16593
26c_29	26c	2054128	0	27290	0	2043774	99.50	2026838	1013419	1013419	1987472	98.06	2014778	1706	0.08	24192	18847
26c_36	26c	2037129	0	22041	0	2030311	99.67	2015088	1007544	1007544	1984964	98.51	2006770	1500	0.07	17356	13014
26c_37	26c	695493	0	8557	0	686025	98.64	686936	343468	343468	667414	97.16	676260	1208	0.18	7738	6301
26c_38	26c	1179875	0	12963	0	1169569	99.13	1166912	583456	583456	1143034	97.95	1155516	1090	0.09	10584	7807
26c_39	26c	134629	0	1453	0	112948	83.90	133176	66588	66588	108154	81.21	110506	989	0.74	2016	1587
26c_40	26c	859840	0	10804	0	840815	97.79	849036	424518	424518	817856	96.33	829022	989	0.12	9788	7293
26c_41	26c	338723	0	5033	0	332362	98.12	333690	166845	166845	320106	95.93	326414	915	0.27	5896	4538
26c_42	26c	1023418	0	9888	0	1013182	99.00	1013530	506765	506765	995154	98.19	1002500	794	0.08	6424	4630
26c_43	26c	859145	0	9191	0	855025	99.52	849954	424977	424977	837490	98.53	845116	718	0.08	6878	4933
26c_44	26c	954533	0	10629	0	940784	98.56	943904	471952	471952	919810	97.45	929008	1147	0.12	7754	5517
26c_45	26c	1498696	0	17324	0	1489891	99.41	1481372	740686	740686	1453300	98.11	1471360	1207	0.08	16596	12607
26c_47	26c	842615	0	7645	0	831282	98.66	834970	417485	417485	816408	97.78	822738	899	0.11	5472	3751
26c_48	26c	776643	0	10337	0	766621	98.71	766306	383153	383153	744292	97.13	755478	806	0.11	9248	6234
26c_49	26c	1372344	0	17206	0	1362989	99.32	1355138	677569	677569	1331218	98.23	1344436	1347	0.10	12206	8603
26c_50	26c	721190	0	7960	0	712712	98.82	713230	356615	356615	696108	97.60	703880	872	0.12	6912	4887
27a_01	27a	2279409	0	37567	0	2272088	99.68	2241842	1120921	1120921	2178680	97.18	2231432	3089	0.14	47026	37741
27a_02	27a	1993334	0	31912	0	1990262	99.85	1961422	980711	980711	1921352	97.96	1957056	1294	0.07	32764	26552
27a_03	27a	2082699	0	37179	0	2078021	99.78	2045520	1022760	1022760	1994898	97.53	2039356	1486	0.07	41072	34590
27a_04	27a	7826552	0	138062	0	7814922	99.85	7688490	3844245	3844245	7506330	97.63	7671928	4932	0.06	152214	123920
27a_05	27a	6702260	0	78516	0	6684366	99.73	6623744	3311872	3311872	6516884	98.39	6600658	5192	0.08	72594	56418
27a_06	27a	491619	0	9749	0	490427	99.76	481870	240935	240935	467832	97.09	480248	430	0.09	10786	9088
27a_07	27a	1462103	0	45373	0	1458332	99.74	1416730	708365	708365	1352364	95.46	1411338	1621	0.11	55698	49448
27a_08	27a	13541890	0	215348	0	13511529	99.78	13326542	6663271	6663271	13028120	97.76	13284856	11325	0.08	230462	187292
27a_09	27a	1433125	0	22209	0	1429821	99.77	1410916	705458	705458	1377562	97.64	1406624	988	0.07	26468	21068
27a_10	27a	393771	0	7867	0	392730	99.74	385904	192952	192952	374774	97.12	384548	315	0.08	8822	7172
27a_11	27a	817126	0	15206	0	815088	99.75	801920	400960	400960	778508	97.08	799076	806	0.10	18760	15719
27a_12	27a	2695960	0	51566	0	2690631	99.80	2644394	1322197	1322197	2572476	97.28	2636714	2351	0.09	58434	47230
27a_13	27a	1653448	0	27458	0	1650560	99.83	1625990	812995	812995	1587142	97.61	1621590	1512	0.09	31434	27027
27a_15	27a	1602324	0	27782	0	1599202	99.81	1574542	787271	787271	1537960	97.68	1570420	1000	0.06	28232	22779
27a_16	27a	2067242	0	30496	0	2062542	99.77	2036746	1018373	1018373	1993688	97.89	2030468	1578	0.08	32412	26819
27a_17	27a	2510603	0	70669	0	2506289	99.83	2439934	1219967	1219967	2339126	95.87	2433862	1758	0.07	85104	75902
27a_18	27a	7053655	0	150881	0	7040092	99.81	6902774	3451387	3451387	6693078	96.96	6882874	6337	0.09	171314	146280
27a_19	27a	91685	0	1165	0	91530	99.83	90520	45260	45260	88796	98.10	90244	121	0.13	1414	977
27a_20	27a	120006	0	2552	0	119680	99.73	117454	58727	58727	113280	96.45	116956	172	0.15	3462	2892
27a_21	27a	126587	0	3071	0	126137	99.64	123516	61758	61758	117560	95.18	122766	300	0.24	4682	4204
27a_22	27a	440457	0	5867	0	439076	99.69	434590	217295	217295	425590	97.93	432866	343	0.08	6336	5094
27a_23	27a	876638	0	18494	0	875343	99.85	858144	429072	429072	830994	96.84	856200	649	0.08	23020	19838
27a_24	27a	2299970	0	60852	0	2295318	99.80	2239118	1119559	1119559	2151412	96.08	2232756	1710	0.08	73398	62976
27a_25	27a	1054409	0	20499	0	1050595	99.64	1033910	516955	516955	1001208	96.84	1028228	1868	0.18	25124	21954
27a_26	27a	1787288	0	23380	0	1783437	99.78	1763908	881954	881954	1729844	98.07	1758502	1555	0.09	24972	19722
27a_27	27a	3065315	0	69409	0	3058597	99.78	2995906	1497953	1497953	2893120	96.57	2986410	2778	0.09	83520	71697
27a_28	27a	1835126	0	35754	0	1831520	99.80	1799372	899686	899686	1753044	97.43	1793734	2032	0.11	37054	30372
27a_29	27a	13998224	0	278628	0	13946335	99.63	13719596	6859798	6859798	13321312	97.10	13656538	11169	0.08	301758	256195
27a_30	27a	198103	0	6329	0	197465	99.68	191774	95887	95887	180698	94.22	190886	250	0.13	9044	8088
27a_31	27a	368379	0	5351	0	366944	99.61	363028	181514	181514	353900	97.49	360772	821	0.23	6266	5158
27a_32	27a	831884	0	11324	0	828995	99.65	820560	410280	410280	798854	97.35	815796	1875	0.23	15258	12834
27a_33	27a	483640	0	5246	0	482660	99.80	478394	239197	239197	470778	98.41	477018	396	0.08	5198	4001
27a_34	27a	284214	0	3494	0	283657	99.80	280720	140360	140360	275768	98.24	279920	243	0.09	3866	3069
27a_35	27a	123522	0	2168	0	123371	99.88	121354	60677	60677	118274	97.46	121068	135	0.11	2476	2047
27a_36	27a	285215	0	4335	0	284178	99.64	280880	140440	140440	273000	97.19	279338	505	0.18	5438	4290
27a_37	27a	1493181	0	27299	0	1490087	99.79	1465882	732941	732941	1432638	97.73	1461530	1258	0.09	26870	21785
27a_38	27a	831130	0	9042	0	829542	99.81	822088	411044	411044	810888	98.64	819872	628	0.08	7646	5448
27a_39	27a	1795396	0	26266	0	1792075	99.82	1769130	884565	884565	1735734	98.11	1764612	1197	0.07	25078	20941
27a_40	27a	385425	0	5915	0	384658	99.80	379510	189755	189755	371850	97.98	378474	269	0.07	6136	5013
27a_41	27a	1730974	0	22240	0	1728108	99.83	1708734	854367	854367	1676784	98.13	1704684	1184	0.07	25222	19319
27a_42	27a	48982	0	844	0	48832	99.69	48138	24069	24069	46280	96.14	47858	130	0.27	1528	1262
27a_43	27a	55520	0	996	0	55200	99.42	54524	27262	27262	52008	95.39	53958	246	0.45	1778	1612
27a_44	27a	661125	0	12869	0	659344	99.73	648256	324128	324128	630084	97.20	645460	1015	0.16	14274	11076
27a_45	27a	834701	0	14003	0	833167	99.82	820698	410349	410349	798436	97.29	818598	566	0.07	18484	14705
27a_46	27a	727807	0	12215	0	726318	99.80	715592	357796	357796	697038	97.41	713572	531	0.07	14710	12572
27a_47	27a	1864541	0	36477	0	1861164	99.82	1828064	914032	914032	1781524	97.45	1823256	1431	0.08	37310	29945
27a_48	27a	3354241	0	64019	0	3347411	99.80	3290222	1645111	1645111	3199600	97.25	3280166	3226	0.10	72480	61834
27a_49	27a	184117	0	4291	0	183173	99.49	179826	89913	89913	171470	95.35	178278	604	0.34	6152	5396
27a_50	27a	537755	0	8295	0	535607	99.60	529460	264730	264730	514264	97.13	526128	1184	0.22	10392	8141
27b_01	27b	2430157	0	30205	0	2423540	99.73	2399952	1199976	1199976	2366698	98.61	2391592	1743	0.07	21958	14652
27b_04	27b	3671125	0	58041	0	3662272	99.76	3613084	1806542	1806542	3553478	98.35	3601806	2425	0.07	43584	33936
27b_06	27b	2633845	0	25153	0	2627952	99.78	2608692	1304346	1304346	2576172	98.75	2600916	1883	0.07	19818	14963
27b_10	27b	3006602	0	39928	0	3000086	99.78	2966674	1483337	1483337	2922352	98.51	2957880	2278	0.08	32788	24101
27b_11	27b	1422468	0	14386	0	1420392	99.85	1408082	704041	704041	1392950	98.93	1405220	786	0.06	11320	8456
27b_14	27b	1646753	0	14519	0	1644176	99.84	1632234	816117	816117	1615158	98.95	1628608	1049	0.06	10586	7383
27b_15	27b	1226538	0	15914	0	1223061	99.72	1210624	605312	605312	1192010	98.46	1206118	1029	0.08	12040	7920
27b_16	27b	2025797	0	27045	0	2022410	99.83	1998752	999376	999376	1972330	98.68	1994130	1235	0.06	19498	14429
27b_18	27b	1148361	0	12459	0	1146258	99.82	1135902	567951	567951	1119238	98.53	1133000	799	0.07	11696	8793
27b_19	27b	3267677	0	35015	0	3261179	99.80	3232662	1616331	1616331	3195238	98.84	3224694	1470	0.05	26398	17711
27b_20	27b	2544532	0	22584	0	2540098	99.83	2521948	1260974	1260974	2495720	98.96	2515728	1786	0.07	16226	12131
27b_21	27b	1764692	0	21802	0	1761363	99.81	1742890	871445	871445	1719416	98.65	1738368	1193	0.07	17576	13368
27b_22	27b	1198955	0	15581	0	1196298	99.78	1183374	591687	591687	1164150	98.38	1179750	967	0.08	13720	8448
27b_24	27b	1157545	0	12939	0	1154784	99.76	1144606	572303	572303	1129136	98.65	1140740	1105	0.10	9594	7251
27b_35	27b	3666104	0	57552	0	3659000	99.81	3608552	1804276	1804276	3543976	98.21	3598542	2906	0.08	48412	34900
27b_37	27b	2618867	0	49841	0	2607364	99.56	2569026	1284513	1284513	2503056	97.43	2554848	2675	0.10	46990	38598
27b_38	27b	442136	0	7290	0	438687	99.22	434846	217423	217423	423708	97.44	430820	577	0.13	6716	5766
27b_40	27b	1352869	0	19113	0	1342585	99.24	1333756	666878	666878	1303206	97.71	1322318	1154	0.09	16214	13280
27b_42	27b	343343	0	3433	0	339483	98.88	339910	169955	169955	332916	97.94	335652	398	0.12	2446	1893
27b_43	27b	393809	0	6297	0	391342	99.37	387512	193756	193756	377248	97.35	384666	379	0.10	7032	5554
27b_48	27b	727075	0	13277	0	720514	99.10	713798	356899	356899	690478	96.73	706458	779	0.11	14856	12575
27b_49	27b	188520	0	2604	0	179752	95.35	185916	92958	92958	173878	93.53	176762	386	0.21	2686	2204
